leisure_need	avakASa_AvaSyakawA/viSrAma_prayojana#avakASa_AvaSyakawA/viSrAma_prayojana#noun#2#RM
level_need	samawala_kamI/samAnawA_mAzga#samawala_kamI/samAnawA_mAzga#noun#2#RM
lifestyle_need	jIvana_SElI_AvaSyakawA#jIvana_SElI_AvaSyakawA#noun#2#RM
literacy_need	sAkRarawA_kamI/sAkRarawA_kI_AvaSyakawA#sAkRarawA_kamI/sAkRarawA_kI_AvaSyakawA#noun#2#RM
living_need	jIvikA_AvaSyakawA/jIvana_nirvAha_prayojana#jIvikA_AvaSyakawA/jIvana_nirvAha_prayojana#noun#2#RM
maintenance_need	anurakRaNa_AvaSyakawA#anurakRaNa_AvaSyakawA#noun#2#RM
management_need	prabanXana_prayojana#prabanXana_prayojana#noun#2#RM
man_need	puruRa_kI_AvaSyakawA/puruRa_kI_kamI#puruRa_kI_AvaSyakawA/puruRa_kI_kamI#noun#2#RM
marketing_need	vipaNana_AvaSyakawA/kraya_vikraya_prayojana#vipaNana_AvaSyakawA/kraya_vikraya_prayojana#noun#2#RM
market_need	bAjZAra_kI_AvaSyakawA#bAjZAra_kI_AvaSyakawA#noun#2#RM
material_need	sAmagrI_AvaSyakawA#sAmagrI_AvaSyakawA#noun#2#RM
meeting_need	bETaka_prayojana/sammelana_AvaSyakawA#bETaka_prayojana/sammelana_AvaSyakawA#noun#2#RM
member_need	saBAsaxa_AvaSyakawA/saxasya_kI_kamI#saBAsaxa_AvaSyakawA/saxasya_kI_kamI#noun#2#RM
mobility_need	gawiSIlawA_kI_kamI#gawiSIlawA_kI_kamI#noun#2#RM
month_need	mAha_prayojana/mAsika_AvaSyakawA#mAha_prayojana/mAsika_AvaSyakawA#noun#2#RM
absentee_landlordism	anupasZWiwa_jamIMxArI#anupasZWiwa_jamIMxArI#adjective#2#RM
absorption_capacity	upayoga_kI_kRamawA#upayoga_kI_kRamawA#noun#2#RM
absorption_characteristics	avaSoRaNa_aBilakRaNa#avaSoRaNa_aBilakRaNa#noun#2#RM
absorption_characteristics	samAveSa_aBilakRaNa#samAveSa_aBilakRaNa#noun#2#RM
abuse_drugs	naSe_yA_SarAba_kI_lawa#naSe_yA_SarAba_kI_lawa#adjective#2#RM
access_initiative	aBigamyawA_hewu_(pahuMca)_pahala#aBigamyawA_hewu_(pahuMca)_pahala#noun#2#RM
access_knowledge	jFAna_kI_pahuMca#jFAna_kI_pahuMca#noun#2#RM
accident_cases	xurGatanA_meM_GAyala_loga#xurGatanA_meM_GAyala_loga#noun#2#RM
accident_prevention	xurGatanA-nivAraka#xurGatanA-nivAraka#noun#2#RM
accident_victims	xurGatanA_ke(meM)_pIdZiwa#xurGatanA_ke(meM)_pIdZiwa#noun#2#RM
accident_victims	xurGatanA-pIdZiwa#xurGatanA-pIdZiwa#noun#2#RM
accommodation_scheme	AvAsa_yojanA#AvAsa_yojanA#noun#2#RM
account_book	hisAba#hisAba#noun#2#RM
account_books	bahI-KAwA#bahI-KAwA#noun#2#RM
account_books	hisAba_kI_bahiyoYz#hisAba_kI_bahiyoYz#noun#2#RM
account_deficit	KAwA_GAtA#KAwA_GAtA#noun#2#RM
account_holders	bacawa_KAwA_(XAraka)#bacawa_KAwA_(XAraka)#noun#2#RM
accountancy_profession	ekAuMteMsI(leKA)_vyavasAya#ekAuMteMsI(leKA)_vyavasAya#noun#2#RM
accreditation_body	prawyAyana_saMsWA,#prawyAyana_saMsWA,#noun#2#RM
accreditation_system	prawyAyana_vyavasWA#prawyAyana_vyavasWA#noun#2#RM
space_processes	aMwarikRa_kI_prakriyAez#aMwarikRa_kI_prakriyAez#noun#2#RM
acquisition_system	hAzsila(prApwa)_karane_kI_praNAlI#hAzsila(prApwa)_karane_kI_praNAlI#noun#2#RM
50_acre_plot	pacAsa_ekadZa_jamIna#pacAsa_ekadZa_jamIna#adjective#2#RM
acre_site	ekadZa_BUmi_kA_sWala#ekadZa_BUmi_kA_sWala#noun#2#RM
one-act_plays	bahuwa_se_ekAMkI_nAtaka#bahuwa_se_ekAMkI_nAtaka#noun#2#RM
seven-act_play	sAwa_aMkoM_kA_nAtaka#sAwa_aMkoM_kA_nAtaka#noun#2#RM
one-act_play	ekAMkI#ekAMkI#noun#2#RM
compact_plays	saMhawa/saMkRipwa_nAtaka#saMhawa/saMkRipwa_nAtaka#noun#2#RM
one-act_play	ekAMkI_nAtaka#ekAMkI_nAtaka#noun#2#RM
five-act_structure	pAMca_aMkoMBAgoM_kI_saMracanA#pAMca_aMkoMBAgoM_kI_saMracanA#noun#2#RM
contracting_company	TekA_kaMpanI#TekA_kaMpanI#noun#2#RM
fraction_planets	AMSika_graha#AMSika_graha#noun#2#RM
action_plans	kArya-yojanAeM#kArya-yojanAeM#noun#2#RM
action_plan	kArya-yojanA#kArya-yojanA#noun#2#RM
action_research	ekSana_risarca/kriyAnveSaNa#ekSana_risarca/kriyAnveSaNa#noun#2#RM
adhesive_tape	cipakane_vAlI_tepa/pattI#cipakane_vAlI_tepa/pattI#noun#2#RM
administration_system	praSAsana_praNAlI#praSAsana_praNAlI#noun#2#RM
admission_charges	praveSa-Sulka#praveSa-Sulka#noun#2#RM
admission_test	yogyawA_kI_parIkRA#yogyawA_kI_parIkRA#noun#2#RM
adoption_cases	goxa_lie-xie_jAne_ke_mAmale#goxa_lie-xie_jAne_ke_mAmale#noun#2#RM
adult_education	prODa-SikRaNa#prODa-SikRaNa#noun#2#RM
adult_education	prODa-SikRA#prODa-SikRA#noun#2#RM
adult_education	prODZa_SikRA#prODZa_SikRA#noun#2#RM
adult_female	vayaska_mAxA#vayaska_mAxA#noun#2#RM
adult_females	prODZa_mAxAeM#prODZa_mAxAeM#noun#2#RM
adult_illiteracy	vayaska_nirakRarawA#vayaska_nirakRarawA#noun#2#RM
adult_learners	prODZa_vixyArWI#prODZa_vixyArWI#noun#2#RM
adult_literacy	prODZa_SikRA#prODZa_SikRA#noun#2#RM
adult_member	prODZa_saxasya#prODZa_saxasya#noun#2#RM
adult_perspective	badZe_vyakwi_kA_najariyA/vayaska_kA_xqRtikoNa#badZe_vyakwi_kA_najariyA/vayaska_kA_xqRtikoNa#noun#2#RM
adult_population	vayaska_janasaMKyA#vayaska_janasaMKyA#noun#2#RM
adult_present	vayaska_varwamAnawA/mOjUxagI#vayaska_varwamAnawA/mOjUxagI#noun#2#RM
adult_society	vayaska_samAja#vayaska_samAja#noun#2#RM
adult_world	badZoM_kI_xuniyA/vayaska_saMsAra#badZoM_kI_xuniyA/vayaska_saMsAra#noun#2#RM
advance_booking	agrima_ArakRaNa/pahale_se_hI_tikata_KarIxa#agrima_ArakRaNa/pahale_se_hI_tikata_KarIxa#noun#2#RM
advance_guard	agrima_surakRA/xaswA#agrima_surakRA/xaswA#noun#2#RM
advance_orders	agrima_mAMga/AxeSa#agrima_mAMga/AxeSa#noun#2#RM
advance_party	agrima_xala#agrima_xala#noun#2#RM
adventure_sports	sAhasika_Kela#sAhasika_Kela#noun#2#RM
adventure_tour	sAhasika_paryatana-yAwrA#sAhasika_paryatana-yAwrA#noun#2#RM
adventure_tourism_activities	sAhasika_paryatana_gawiviXiyAM#sAhasika_paryatana_gawiviXiyAM#noun#2#RM
advertising_campaigns	pracAra_aBiyAna/vijFApana_aBiyAna#pracAra_aBiyAna/vijFApana_aBiyAna#noun#2#RM
advertising_copy	vijFApana_prawi/vijFApana_meM_xarSAyA_gayA_viRaya#vijFApana_prawi/vijFApana_meM_xarSAyA_gayA_viRaya#noun#2#RM
advertising_manager	vijFApana_prabaMXaka#vijFApana_prabaMXaka#noun#2#RM
afternoon_sun	xopahara_kI_XUpa/maXyAnha_kA_sUrya#xopahara_kI_XUpa/maXyAnha_kA_sUrya#noun#2#RM
afternoon_tea	xopahara_kI_cAya/xopahara_kA_cAya_nASwA#xopahara_kI_cAya/xopahara_kA_cAya_nASwA#noun#2#RM
average_audience	Osawa_xarSaka/Osawana_xarSaka_upasWiwi#Osawa_xarSaka/Osawana_xarSaka_upasWiwi#noun#2#RM
storage_capacity	goxAma_kRamawA/goxAmoM_kI_kRamawA#goxAma_kRamawA/goxAmoM_kI_kRamawA#noun#2#RM
storage_capacity	surakRiwa_raKane_kI_kRamawA/raKa_raKAva_kRamawA#surakRiwa_raKane_kI_kRamawA/raKa_raKAva_kRamawA#noun#2#RM
average_capacity	Osawa_kRamawA#Osawa_kRamawA#noun#2#RM
heritage_category	herIteja_varga/virAsawa/paramparA_kI_SreNI#herIteja_varga/virAsawa/paramparA_kI_SreNI#noun#2#RM
village_children	gAzva_ke_bacce#gAzva_ke_bacce#noun#2#RM
age_children	badZI_umra_ke_bacce#badZI_umra_ke_bacce#noun#2#RM
children_age	baccoM_kI_Ayu#baccoM_kI_Ayu#noun#2#RM
school-age_children	skUla_Ayu_ke_bacce#skUla_Ayu_ke_bacce#noun#2#RM
language_classes	BARA_kI_kakRAez#BARA_kI_kakRAez#noun#2#RM
age_group	Ayu_varga#Ayu_varga#noun#2#RM
village_home	grAma_gqha/gAzva_ke_Gara#grAma_gqha/gAzva_ke_Gara#noun#2#RM
old-age_homes	vqxvoM_ke_lie_banA_ASrama#vqxvoM_ke_lie_banA_ASrama#noun#2#RM
old_age_homes	vqxvASrama#vqxvASrama#noun#2#RM
village_homes	nikatavarwI_gAzva/gAzva_ke_nikatavarwI_Gara#nikatavarwI_gAzva/gAzva_ke_nikatavarwI_Gara#noun#2#RM
stage_increase	swarIya_vqxXi#swarIya_vqxXi#noun#2#RM
average_increase	Osawana_vqxXi#Osawana_vqxXi#noun#2#RM
village_level	gAzva-swara#gAzva-swara#noun#2#RM
unit_village_levels	ikAIvAra_grAma_swara#ikAIvAra_grAma_swara#noun#2#RM
collage_level	mahAvixyAlaya/kAleja_swara#mahAvixyAlaya/kAleja_swara#noun#2#RM
illage_levels	grAmINa_swara#grAmINa_swara#noun#2#RM
age_limit	Ayu_sImA#Ayu_sImA#noun#2#RM
wage_limit	vewana_sImA/nirXAraNa#vewana_sImA/nirXAraNa#noun#2#RM
village_love	gAzva_ke_prawi_prema/lagAva#gAzva_ke_prawi_prema/lagAva#noun#2#RM
stage_manager	maMca_prabanXaka/sUwraXAra#maMca_prabanXaka/sUwraXAra#noun#2#RM
storage_management	BaMdAraNa_prabanXana#BaMdAraNa_prabanXana#noun#2#RM
average_man	Ama_AxamI#Ama_AxamI#noun#2#RM
remarriage_movement	punarvivAha_AMxolana#punarvivAha_AMxolana#noun#2#RM
village_music	grAma_saMgIwa/loka_saMgIwa#grAma_saMgIwa/loka_saMgIwa#noun#2#RM
marriage_party	bArAwa#bArAwa#noun#2#RM
foliage_patterns	belabUtoM_kI_nakkASI#belabUtoM_kI_nakkASI#noun#2#RM
teenage_peer	kiSora_sAWI#kiSora_sAWI#noun#2#RM
old_age_pension	vqxXAvasWA_peMSana#vqxXAvasWA_peMSana#noun#2#RM
old_age	vqxXAvasWA#vqxXAvasWA#noun#2#RM
village_people	grAmavAsI#grAmavAsI#noun#2#RM
village_people	xehAwI_loga#xehAwI_loga#noun#2#RM
village_people	grAmINa_janawA#grAmINa_janawA#noun#2#RM
village_people	gAMva_ke_loga#gAMva_ke_loga#noun#2#RM
stage_personality	raMgamaMcIya_vyakwiwva#raMgamaMcIya_vyakwiwva#noun#2#RM
stage_personalities	badZe_badZe_aBinewA#badZe_badZe_aBinewA#noun#2#RM
language_question	BARA_sambanXI_praSna#BARA_sambanXI_praSna#noun#2#RM
age_range	Ayu_varga/umra_viSeRa_ke_anxara#Ayu_varga/umra_viSeRa_ke_anxara#noun#2#RM
primary-school-age_range	prAimarI_skUla_kA_Ayu_swara#prAimarI_skUla_kA_Ayu_swara#noun#2#RM
toencourage_research	anusaMXAna_ko_baDZAvA_xenA#anusaMXAna_ko_baDZAvA_xenA#verb#2#RM
damage_result	kRawi_pariNAma#kRawi_pariNAma#noun#2#RM
average_sales	Osawana_bikrI#Osawana_bikrI#noun#2#RM
village_service	grAma_sevA#grAma_sevA#noun#2#RM
beverage_services	peya_sevAez#peya_sevAez#noun#2#RM
drainage_structures	pAnI_nikAsI_kA_DAMcA#pAnI_nikAsI_kA_DAMcA#noun#2#RM
storage_structures	BaMdAraNa_kI_suviXAez#BaMdAraNa_kI_suviXAez#noun#2#RM
storage_structures	BaMdAraNa_sAXana#BaMdAraNa_sAXana#noun#2#RM
average_student	sAmAnya_vixyArWI#sAmAnya_vixyArWI#noun#2#RM
manage_things	vaswuoM_kA_prabaMXana#vaswuoM_kA_prabaMXana#verb#1#RM
stage_today	varwamAna_maMca#varwamAna_maMca#noun#2#RM
manage_today	varwamAna_kA_prabaMXana#varwamAna_kA_prabaMXana#noun#2#RM
percentage_variations	Osawana_anwara#Osawana_anwara#noun#2#RM
age_verification	Ayu_kI_puRti#Ayu_kI_puRti#noun#2#RM
image_worship	mUrwi_pUjA#mUrwi_pUjA#noun#2#RM
rage_years	pracaNda_varRa/rURta_awIwa#pracaNda_varRa/rURta_awIwa#noun#2#RM
multi-agency_approach	bahu_mAXyama_praNAlI#bahu_mAXyama_praNAlI#noun#2#RM
agency_basis	ejeMsI_AXAra#ejeMsI_AXAra#noun#2#RM
agency_basis	ejeMsI_praNAlI/ejeMsI_ke_wOra_warIke#ejeMsI_praNAlI/ejeMsI_ke_wOra_warIke#noun#2#RM
agency_include	ejeMsI_samanvaya#ejeMsI_samanvaya#noun#2#RM
agent_provocateur	ejeMtoM_ko_BafakAne_vAlA#ejeMtoM_ko_BafakAne_vAlA#noun#2#RM
agriculture_sector	kqRi_kRewra#kqRi_kRewra#noun#2#RM
aid_levels	sahAyawA_ke_swara#sahAyawA_ke_swara#noun#2#RM
code_page	kUta_pqRTa#kUta_pqRTa#noun#2#RM
home_page	AmuKa_pqRTa#AmuKa_pqRTa#noun#2#RM
memory_page	smqwi_pqRTa#smqwi_pqRTa#noun#2#RM
title_page	muKa_pqRTa#muKa_pqRTa#noun#2#RM
web_page	veba_pqRTa#veba_pqRTa#noun#2#RM
page_break	pqRTAnwaraNa#pqRTAnwaraNa#noun#2#RM
page_control	pqRTa_niyanwraNa#pqRTa_niyanwraNa#noun#2#RM
page_directory	pqRTa_nirxeSikA#pqRTa_nirxeSikA#noun#2#RM
page_display	pqRTa_praxarSa#pqRTa_praxarSa#noun#2#RM
page_failure	pqRTa_viPalawA#pqRTa_viPalawA#noun#2#RM
page_fault	pqRTa_xoRa#pqRTa_xoRa#noun#2#RM
page_heading	pqRTa_SIrRaka#pqRTa_SIrRaka#noun#2#RM
page_reader	pqRTa_paTiwra(pATaka)#pqRTa_paTiwra(pATaka)#noun#2#RM
page_size	pqRTa_mApa(parimANa)#pqRTa_mApa(parimANa)#noun#2#RM
page_table	pqRTa_sAraNI#pqRTa_sAraNI#noun#2#RM
quality_paper	guNavawwA_yukwa_kAgaja/SreRTa_pawra#guNavawwA_yukwa_kAgaja/SreRTa_pawra#noun#2#RM
question_paper	praSna_pawra#praSna_pawra#noun#2#RM
rag_paper	rEga_kAgaja/kapadZe_se_yukwa_kAgaja#rEga_kAgaja/kapadZe_se_yukwa_kAgaja#noun#2#RM
reference_paper	sanxarBa_pawra#sanxarBa_pawra#noun#2#RM
research_paper	SoXa_pawra#SoXa_pawra#noun#2#RM
review_paper	samIkRA_pawra#samIkRA_pawra#noun#2#RM
sample_paper	namUnA(sEmpala)_pawra#namUnA(sEmpala)_pawra#noun#2#RM
scrap_paper	raxxI_kAgaja#raxxI_kAgaja#noun#2#RM
selling_paper	bikrI_kA_kAgaja/vikraya_pawra#bikrI_kA_kAgaja/vikraya_pawra#noun#2#RM
semester_paper	arXa_vArRika_pawra#arXa_vArRika_pawra#noun#2#RM
seminar_paper	saMgoRTI(seminAra)_pawra#saMgoRTI(seminAra)_pawra#noun#2#RM
shakespeare_paper	SeksapIyara_para_liKA_leKa(pawra)#SeksapIyara_para_liKA_leKa(pawra)#noun#2#RM
specimen_paper	AxarSa_pawra/namUnA_kAgaja#AxarSa_pawra/namUnA_kAgaja#noun#2#RM
stage_paper	maMca_pawra/aBinaya_pawra#maMca_pawra/aBinaya_pawra#noun#2#RM
stock_paper	BaNdAra_pawra/kunxA_pawra#BaNdAra_pawra/kunxA_pawra#noun#2#RM
strategy_paper	kAryanIwi_leKa_pawra#kAryanIwi_leKa_pawra#noun#2#RM
student_paper	vixyArWI_leKa_pawra#vixyArWI_leKa_pawra#noun#2#RM
study_paper	aXyayana_pawra#aXyayana_pawra#noun#2#RM
sugar_paper	Sakkara_yukwa_kAgaja#Sakkara_yukwa_kAgaja#noun#2#RM
summary_paper	sArAMSa_pawra#sArAMSa_pawra#noun#2#RM
sunday_paper	ravivArIya_samAcAra_pawra_aMka#ravivArIya_samAcAra_pawra_aMka#noun#2#RM
support_paper	samarWana_pawra#samarWana_pawra#noun#2#RM
surveyor_paper	sarvekRaka_pawra/nirIkRaka_xaswAveja#sarvekRaka_pawra/nirIkRaka_xaswAveja#noun#2#RM
symposium_paper	parisaMvAxa_pawra/vicAra_goRTI_pawra#parisaMvAxa_pawra/vicAra_goRTI_pawra#noun#2#RM
term_paper	prawijFA(Sarwa)_pawra/miyAxI_xaswAveja#prawijFA(Sarwa)_pawra/miyAxI_xaswAveja#noun#2#RM
test_paper	parIkRA_pawra/jAzca_pawra#parIkRA_pawra/jAzca_pawra#noun#2#RM
text_paper	pATya_puswaka_pawra#pATya_puswaka_pawra#noun#2#RM
theory_paper	sixXAnwa(sExXAnwika)_pawra#sixXAnwa(sExXAnwika)_pawra#noun#2#RM
toilet_paper	prasAXana_pawra/SOca_SuxXi_kA_kAgajZa#prasAXana_pawra/SOca_SuxXi_kA_kAgajZa#noun#2#RM
tone_paper	majabUwa_kAgaja#majabUwa_kAgaja#noun#2#RM
touch_paper	sparSa_pawra/halakA(halkA)_kAgaja#sparSa_pawra/halakA(halkA)_kAgaja#noun#2#RM
trade_paper	vyavasAya_pawra/KZarIxAra_xaswAveja#vyavasAya_pawra/KZarIxAra_xaswAveja#noun#2#RM
update_paper	axyawanIkqwa_pawra(xaswAveja)#axyawanIkqwa_pawra(xaswAveja)#noun#2#RM
view_paper	sammawi_pawra/vicAra_pawra#sammawi_pawra/vicAra_pawra#noun#2#RM
voting_paper	mawaxAna_pawra#mawaxAna_pawra#noun#2#RM
waste_paper	raxxI_kAgajZa#raxxI_kAgajZa#noun#2#RM
wax_paper	momI(moma_yukwa)_kAgajZa#momI(moma_yukwa)_kAgajZa#noun#2#RM
weekend_paper	sapwAhAnwa_samAcAra_pawra#sapwAhAnwa_samAcAra_pawra#noun#2#RM
weight_paper	xabAva_pawra/BArI_kAgaja#xabAva_pawra/BArI_kAgaja#noun#2#RM
word_paper	prawijFA_pawra/saMkewa_Sabxa_xaswAveja#prawijFA_pawra/saMkewa_Sabxa_xaswAveja#noun#2#RM
year_paper	varRa(saMvaw)_pawra/Ayu_xaswAveja#varRa(saMvaw)_pawra/Ayu_xaswAveja#noun#2#RM
gas_safety	gEsa_se_bacAva#gEsa_se_bacAva#noun#2#RM
health_safety	svAsWya_surakRA#svAsWya_surakRA#noun#2#RM
highway_safety	rAjamArga_surakRA#rAjamArga_surakRA#noun#2#RM
home_safety	gqha_surakRA#gqha_surakRA#noun#2#RM
internet_safety	iMtaraneta_surakRA#iMtaraneta_surakRA#noun#2#RM
laser_safety	lejara_surakRA/wIvra_prakASa_se_bacAva#lejara_surakRA/wIvra_prakASa_se_bacAva#noun#2#RM
life_safety	jIvana_surakRA#jIvana_surakRA#noun#2#RM
lift_safety	liPta_surakRA#liPta_surakRA#noun#2#RM
load_safety	BAra_surakRA#BAra_surakRA#noun#2#RM
meat_safety	mAzsa_rakRA#mAzsa_rakRA#noun#2#RM
medication_safety	ORaXi_prayoga_surakRA(bacAva)#ORaXi_prayoga_surakRA(bacAva)#noun#2#RM
motorcycle_safety	motarasAikila(PataPatI)_surakRA#motarasAikila(PataPatI)_surakRA#noun#2#RM
mountain_safety	parvawa_rakRA#parvawa_rakRA#noun#2#RM
neighbourhood_safety	padZosa_bacAva(surakRA)/nikatavarwI_sWAna_surakRA#padZosa_bacAva(surakRA)/nikatavarwI_sWAna_surakRA#noun#2#RM
officer_safety	aXikArI_surakRA#aXikArI_surakRA#noun#2#RM
operator_safety	paricAlaka_surakRA#paricAlaka_surakRA#noun#2#RM
other_safety	anya_bacAva(surakRA)/viparIwa_rakRA#anya_bacAva(surakRA)/viparIwa_rakRA#noun#2#RM
page_safety	pqRTa(pqRTAMkiwa)_bacAva(rakRA)#pqRTa(pqRTAMkiwa)_bacAva(rakRA)#noun#2#RM
passenger_safety	yAwrI_surakRA#yAwrI_surakRA#noun#2#RM
patient_safety	rogI_bacAva(surakRA)#rogI_bacAva(surakRA)#noun#2#RM
phone_safety	xUraBARa_yaMwra_(telIPona)_bacAva(rakRA)#xUraBARa_yaMwra_(telIPona)_bacAva(rakRA)#noun#2#RM
pool_safety	wAla_surakRA/Cote_wAlAba_kA_raKa_raKAva#wAla_surakRA/Cote_wAlAba_kA_raKa_raKAva#noun#2#RM
production_safety	uwpAxana_surakRA#uwpAxana_surakRA#noun#2#RM
product_safety	uwpAxa_surakRA/pExAvAra_bacAva#uwpAxa_surakRA/pExAvAra_bacAva#noun#2#RM
radiation_safety	vikiraNa_bacAva#vikiraNa_bacAva#noun#2#RM
rail_safety	rela(relagAdZI)_surakRA#rela(relagAdZI)_surakRA#noun#2#RM
rider_safety	savAra(GudZasavAra)_surakRA#savAra(GudZasavAra)_surakRA#noun#2#RM
road_safety	sadZaka_surakRA#sadZaka_surakRA#noun#2#RM
ship_safety	jahAjZa_surakRA#jahAjZa_surakRA#noun#2#RM
site_safety	sWAna(kAryasWala)_surakRA#sWAna(kAryasWala)_surakRA#noun#2#RM
spectator_safety	xarSaka(aXiprekRaka)_surakRA#xarSaka(aXiprekRaka)_surakRA#noun#2#RM
stability_safety	sWirawA_hewu_bacAva#sWirawA_hewu_bacAva#noun#2#RM
staff_safety	karmacArI_surakRA#karmacArI_surakRA#noun#2#RM
sun_safety	XUpa_se_bacAva#XUpa_se_bacAva#noun#2#RM
system_safety	vyavasWA_surakRA#vyavasWA_surakRA#noun#2#RM
traffic_safety	yAwAyAwa_surakRA#yAwAyAwa_surakRA#noun#2#RM
transfusion_safety	(rakwa)_AXAna_surakRA#(rakwa)_AXAna_surakRA#noun#2#RM
transport_safety	parivahana_surakRA#parivahana_surakRA#noun#2#RM
vaccine_safety	tIkA_sambanXI_bacAva#tIkA_sambanXI_bacAva#noun#2#RM
vehicle_safety	vAhana_surakRA#vAhana_surakRA#noun#2#RM
water_safety	jala_surakRA/jala_se_bacAva#jala_surakRA/jala_se_bacAva#noun#2#RM
wear_safety	vaswra_rakRA#vaswra_rakRA#noun#2#RM
worker_safety	Sramika_surakRA#Sramika_surakRA#noun#2#RM
workplace_safety	kArya_sWala_surakRA#kArya_sWala_surakRA#noun#2#RM
auction_sale	nIlAmI_kI_jAne_vAlI_vaswuoM_kI_bikrI#nIlAmI_kI_jAne_vAlI_vaswuoM_kI_bikrI#noun#2#RM
boot_sale	lABa_hewu_bikrI/jUwoM_kI_bikrI#lABa_hewu_bikrI/jUwoM_kI_bikrI#noun#2#RM
cash_sale	nakaxa_vikraya#nakaxa_vikraya#noun#2#RM
credit_sale	uXAra_bikrI#uXAra_bikrI#noun#2#RM
fire_sale	Aga_xvArA_kRawigraswa_vaswuoM_kA_vikraya#Aga_xvArA_kRawigraswa_vaswuoM_kA_vikraya#noun#2#RM
garage_sale	gEreja_meM_raKI_huI_vaswuoM_kA_vikraya#gEreja_meM_raKI_huI_vaswuoM_kA_vikraya#noun#2#RM
season_sale	mOsama_anusAra_bikrI/upayukwa_kAlAnusAra_vikraya#mOsama_anusAra_bikrI/upayukwa_kAlAnusAra_vikraya#noun#2#RM
share_sale	prawiBUwi(Seyara)_bikrI#prawiBUwi(Seyara)_bikrI#noun#2#RM
ship_sale	jalayAna_xvArA_bikrI/jahAja_vikraya#jalayAna_xvArA_bikrI/jahAja_vikraya#noun#2#RM
shop_sale	xukAna_xvArA_bikrI#xukAna_xvArA_bikrI#noun#2#RM
single_sale	eka_hI_vaswu_kI_bikrI/eka_hI_sWAna_se_vikraya#eka_hI_vaswu_kI_bikrI/eka_hI_sWAna_se_vikraya#noun#2#RM
software_sale	soYPtaveyara_(kI)_bikrI#soYPtaveyara_(kI)_bikrI#noun#2#RM
spring_sale	vasanwa_(qwu_kI)_bikrI#vasanwa_(qwu_kI)_bikrI#noun#2#RM
stick_sale	anivArya_bikrI/kARTa_vikraya#anivArya_bikrI/kARTa_vikraya#noun#2#RM
stock_sale	Seyara_bAjAra_meM_bikrI/mAla_vikraya#Seyara_bAjAra_meM_bikrI/mAla_vikraya#noun#2#RM
store_sale	goxAma_bikrI/BaNdAra_se_sIXI_bikrI#goxAma_bikrI/BaNdAra_se_sIXI_bikrI#noun#2#RM
studio_sale	SilpaSAlA(stUdiyo)_xvArA_bikrI#SilpaSAlA(stUdiyo)_xvArA_bikrI#noun#2#RM
summer_sale	grIRmakAlIna_bikrI#grIRmakAlIna_bikrI#noun#2#RM
telephone_sale	xUraBARa_xvArA_bikrI#xUraBARa_xvArA_bikrI#noun#2#RM
ticket_sale	tikata_bikrI#tikata_bikrI#noun#2#RM
timber_sale	latTe_kI_bikrI/kARTa(lakadZI)_vikraya#latTe_kI_bikrI/kARTa(lakadZI)_vikraya#noun#2#RM
trade_sale	vyApArika_vikraya#vyApArika_vikraya#noun#2#RM
treaty_sale	vyApArika_saMXi_xvArA_bikrI#vyApArika_saMXi_xvArA_bikrI#noun#2#RM
value_sale	mUlyaparaka_bikrI/upayogI_bikrI#mUlyaparaka_bikrI/upayogI_bikrI#noun#2#RM
vehicle_sale	vAhana_bikrI#vAhana_bikrI#noun#2#RM
volume_sale	viswAra_vikraya#viswAra_vikraya#noun#2#RM
warrant_sale	anujFA_pawra_(aXipawra)_xvArA_vikraya#anujFA_pawra_(aXipawra)_xvArA_vikraya#noun#2#RM
water_sale	jala(jalApUrwi)_vikraya#jala(jalApUrwi)_vikraya#noun#2#RM
weapon_sale	AyuXa_vikraya/haWiyAra_bikrI#AyuXa_vikraya/haWiyAra_bikrI#noun#2#RM
week_sale	sapwAha_Bara_bikrI#sapwAha_Bara_bikrI#noun#2#RM
wife_sale	pawnI_xvArA_bikrI#pawnI_xvArA_bikrI#noun#2#RM
wine_sale	maxirA_vikraya/SarAba_bikrI#maxirA_vikraya/SarAba_bikrI#noun#2#RM
winter_sale	SIwakAlIna_bikrI#SIwakAlIna_bikrI#noun#2#RM
world_sale	viSva_swarIya_vikraya#viSva_swarIya_vikraya#noun#2#RM
yard_sale	ahAwA(yArda)_meM_kI_jAne_vAlI_bikrI#ahAwA(yArda)_meM_kI_jAne_vAlI_bikrI#noun#2#RM
access_session	aXigama_sawra#aXigama_sawra#noun#2#RM
activity_session	gawiviXi_sawra#gawiviXi_sawra#noun#2#RM
advice_session	parAmarSa_bETaka/salAha_sawra#parAmarSa_bETaka/salAha_sawra#noun#2#RM
afternoon_session	aparAhna_sawra#aparAhna_sawra#noun#2#RM
album_session	elabama_se_sambaxXa_sawra#elabama_se_sambaxXa_sawra#noun#2#RM
answer_session	uwwara(spaRtIkaraNa)_sawra#uwwara(spaRtIkaraNa)_sawra#noun#2#RM
art_session	kalA_sawra#kalA_sawra#noun#2#RM
assessment_session	mUlyAzkana_bETaka#mUlyAzkana_bETaka#noun#2#RM
assistance_session	sahayoga_hewu_saBA/sahAyawA_hewu_bETaka#sahayoga_hewu_saBA/sahAyawA_hewu_bETaka#noun#2#RM
autograph_session	sva_haswa_leKa_hewu_sawra/haswAkRara_leKana_sawra#sva_haswa_leKa_hewu_sawra/haswAkRara_leKana_sawra#noun#2#RM
autumn_session	Saraxa_kAlIna_sawra#Saraxa_kAlIna_sawra#noun#2#RM
awareness_session	jAgarUkawA_sawra/jAnakArI_hewu_saBA#jAgarUkawA_sawra/jAnakArI_hewu_saBA#noun#2#RM
beginner_session	AraMBaka_sawra/nOsiKiyA_hewu_sawra#AraMBaka_sawra/nOsiKiyA_hewu_sawra#noun#2#RM
brain_session	cinwana_paraka_sawra/buxXijIviyoM_kA_aXiveSana#cinwana_paraka_sawra/buxXijIviyoM_kA_aXiveSana#noun#2#RM
brainstorming_session	vicArowwejaka_sawra/racanAwmaka_vicAra_hewu_sawra#vicArowwejaka_sawra/racanAwmaka_vicAra_hewu_sawra#noun#2#RM
briefing_session	vivaraNa_hewu_saBA/saMkRipwa_jAnakArI_hewu_bETaka#vivaraNa_hewu_saBA/saMkRipwa_jAnakArI_hewu_bETaka#noun#2#RM
calibration_session	aMSAMkana_bETaka/aMSaSoXana_sawra#aMSAMkana_bETaka/aMSaSoXana_sawra#noun#2#RM
chat_session	vicAra_vimarSa_sawra/bAwacIwa_bETaka#vicAra_vimarSa_sawra/bAwacIwa_bETaka#noun#2#RM
classroom_session	kakRA_sawra/prakoRTa_saBA#kakRA_sawra/prakoRTa_saBA#noun#2#RM
class_session	guNavawwA_hewu_bETaka/varga_(swarIya)_saBA#guNavawwA_hewu_bETaka/varga_(swarIya)_saBA#noun#2#RM
clinic_session	nixAnikA_saBA/cikiwsAlayIya_sawra#nixAnikA_saBA/cikiwsAlayIya_sawra#noun#2#RM
closing_session	samApana_sawra#samApana_sawra#noun#2#RM
cluster_session	samUha_bETaka#samUha_bETaka#noun#2#RM
coaching_session	SikRA_xene_hewu_sawra#SikRA_xene_hewu_sawra#noun#2#RM
communication_session	saMsUcana_hewu_bETaka/saMcAraNa_saBA#saMsUcana_hewu_bETaka/saMcAraNa_saBA#noun#2#RM
computer_session	kampyUtara_sawra#kampyUtara_sawra#noun#2#RM
conference_session	vArwAlApa_sawra#vArwAlApa_sawra#noun#2#RM
consultancy_session	parAmarSa_bETaka#parAmarSa_bETaka#noun#2#RM
consultation_session	vicAra_vimarSa_saBA/manwraNA_bETaka#vicAra_vimarSa_saBA/manwraNA_bETaka#noun#2#RM
contact_session	samparka_sawra/sambanXa_saBA#samparka_sawra/sambanXa_saBA#noun#2#RM
control_session	saMcAlana_hewu_bETaka/niyanwraNa_hewu_saBA#saMcAlana_hewu_bETaka/niyanwraNa_hewu_saBA#noun#2#RM
cookery_session	pAkaSAswra_sawra/pAka_viXi_sawra#pAkaSAswra_sawra/pAka_viXi_sawra#noun#2#RM
counseling_session	parAmarSa_sawra#parAmarSa_sawra#noun#2#RM
course_session	pATyakrama_sawra#pATyakrama_sawra#noun#2#RM
court_session	nyAyAlaya_sawra#nyAyAlaya_sawra#noun#2#RM
craft_session	Silpa_kalA_sawra//Silpa_kalA_aXiveSana#Silpa_kalA_sawra//Silpa_kalA_aXiveSana#noun#2#RM
crash_session	alpakAlIna_sawra#alpakAlIna_sawra#noun#2#RM
dance_session	nqwya_sawra#nqwya_sawra#noun#2#RM
day_session	xivA_sawra/xivasa_kAlika_bETaka#xivA_sawra/xivasa_kAlika_bETaka#noun#2#RM
debut_session	prAraMBika_sawra#prAraMBika_sawra#noun#2#RM
demonstration_session	praxarSana_sawra/prawipAxana_saBA#praxarSana_sawra/prawipAxana_saBA#noun#2#RM
demo_session	praxarSana_sawra#praxarSana_sawra#noun#2#RM
depth_session	gahana_vicAra_hewu_bETaka/gaMBIra_sawra#gahana_vicAra_hewu_bETaka/gaMBIra_sawra#noun#2#RM
development_session	vikAsa_hewu_sawra/parivarXana_hewu_bETaka#vikAsa_hewu_sawra/parivarXana_hewu_bETaka#noun#2#RM
digging_session	Kanana_sawra/KuxAI_hewu_bETaka#Kanana_sawra/KuxAI_hewu_bETaka#noun#2#RM
discussion_session	paricarcA_sawra#paricarcA_sawra#noun#2#RM
drinking_session	maxirA_pAna_sawra/peya_paxArWa_hewu_bETaka#maxirA_pAna_sawra/peya_paxArWa_hewu_bETaka#noun#2#RM
education_session	SikRA_sawra#SikRA_sawra#noun#2#RM
emergency_session	ApAwakAlIna_sawra#ApAwakAlIna_sawra#noun#2#RM
evaluation_session	mUlyAMkana_sawra#mUlyAMkana_sawra#noun#2#RM
evening_session	sAyazkAlIna_sawra#sAyazkAlIna_sawra#noun#2#RM
examination_session	parIkRA_sawra#parIkRA_sawra#noun#2#RM
exercise_session	aByAsa_sawra/vyAyAma_sawra#aByAsa_sawra/vyAyAma_sawra#noun#2#RM
expert_session	viSeRajFa_sambaxXa_sawra/xakRawA_hewu_bETaka#viSeRajFa_sambaxXa_sawra/xakRawA_hewu_bETaka#noun#2#RM
family_session	pArivArika_bETaka#pArivArika_bETaka#noun#2#RM
feedback_session	prawipuRti_sawra#prawipuRti_sawra#noun#2#RM
fishing_session	mawsya_grahaNa_sawra#mawsya_grahaNa_sawra#noun#2#RM
fitness_session	svasWa_rahane_hewu_sawra/xuruswI_sawra#svasWa_rahane_hewu_sawra/xuruswI_sawra#noun#2#RM
focus_session	kenxrIkaraNa_hewu_bETaka/saMkenxra_sawra#kenxrIkaraNa_hewu_bETaka/saMkenxra_sawra#noun#2#RM
football_session	PutaboYla_ke_Kela_kA_sawra#PutaboYla_ke_Kela_kA_sawra#noun#2#RM
forum_session	saMgoRTI_saBA/Porama_bETaka#saMgoRTI_saBA/Porama_bETaka#noun#2#RM
fun_session	Amoxa_pramoxa_sawra/manoraMjana_hewu_saBA#Amoxa_pramoxa_sawra/manoraMjana_hewu_saBA#noun#2#RM
game_session	Kela_sawra#Kela_sawra#noun#2#RM
gaming_session	juA_sawra/xyUwa_krIdZA_sawra#juA_sawra/xyUwa_krIdZA_sawra#noun#2#RM
group_session	samUha_bETaka/samuxAya_saBA#samUha_bETaka/samuxAya_saBA#noun#2#RM
gym_session	vyAyAma_sawra#vyAyAma_sawra#noun#2#RM
healing_session	upacAra_sawra/Arogyakara_sawra#upacAra_sawra/Arogyakara_sawra#noun#2#RM
hill_session	parvawIya_sawra#parvawIya_sawra#noun#2#RM
hypnotherapy_session	sammohana_cikiwsA_sawra#sammohana_cikiwsA_sawra#noun#2#RM
induction_session	praveSaNa_sawra/prAraMBika_saBA#praveSaNa_sawra/prAraMBika_saBA#noun#2#RM
information_session	sUcanA_sawra/jAnakArI_hewu_bETaka#sUcanA_sawra/jAnakArI_hewu_bETaka#noun#2#RM
interest_session	aBiruci_sawra#aBiruci_sawra#noun#2#RM
interview_session	sAkRAwkAra_sawra#sAkRAwkAra_sawra#noun#2#RM
kirk_session	girajAGara_se_sambanXiwa_saBA#girajAGara_se_sambanXiwa_saBA#noun#2#RM
laboratory_session	prayogaSAlA_sawra#prayogaSAlA_sawra#noun#2#RM
lab_session	prayogaSAlA_sawra#prayogaSAlA_sawra#noun#2#RM
lap_session	samApana_sawra/aMkAnusAra_bETaka#samApana_sawra/aMkAnusAra_bETaka#noun#2#RM
lecture_session	vyAKyAna_sawra#vyAKyAna_sawra#noun#2#RM
library_session	puswakAlaya_sawra#puswakAlaya_sawra#noun#2#RM
lunchtime_session	maXyAnha_Bojana_kAlIna_sawra#maXyAnha_Bojana_kAlIna_sawra#noun#2#RM
mediation_session	maXyasWawA_bETaka#maXyasWawA_bETaka#noun#2#RM
mentoring_session	parAmarSa_sawra/salAha_bETaka#parAmarSa_sawra/salAha_bETaka#noun#2#RM
mike_session	mAikroPona_sawra/kArya_vimuKa_hewu_saBA#mAikroPona_sawra/kArya_vimuKa_hewu_saBA#noun#2#RM
min_session	laGuwwama_bETaka/alpa_sawra#laGuwwama_bETaka/alpa_sawra#noun#2#RM
minute_session	saBA_vivaraNa_sawra/alpAvaXi_bETaka#saBA_vivaraNa_sawra/alpAvaXi_bETaka#noun#2#RM
morning_session	prAwaH_kAlIna_sawra#prAwaH_kAlIna_sawra#noun#2#RM
movement_session	gawiviXi_sawra#gawiviXi_sawra#noun#2#RM
music_session	saMgIwa_saBA#saMgIwa_saBA#noun#2#RM
networking_session	netavarka_hewu_sawra/viswAra_sawra#netavarka_hewu_sawra/viswAra_sawra#noun#2#RM
neurology_session	snAyu_vijFAna_sawra#snAyu_vijFAna_sawra#noun#2#RM
night_session	rAwri_kAlIna_sawra#rAwri_kAlIna_sawra#noun#2#RM
panel_session	cayanaka_xala_bETaka#cayanaka_xala_bETaka#noun#2#RM
photography_session	PotogrAPI_sawra#PotogrAPI_sawra#noun#2#RM
photo_session	Poto_sawra/CAyA_ciwra_sawra#Poto_sawra/CAyA_ciwra_sawra#noun#2#RM
planning_session	niyojana_hewu_saBA#niyojana_hewu_saBA#noun#2#RM
plan_session	yojanA_hewu_bETaka#yojanA_hewu_bETaka#noun#2#RM
play_session	Kela_sawra#Kela_sawra#noun#2#RM
pool_session	vaswu_aWavA_vyakwi_samuccaya_saBA#vaswu_aWavA_vyakwi_samuccaya_saBA#noun#2#RM
poster_session	vijFApana_sawra/postara_sawra#vijFApana_sawra/postara_sawra#noun#2#RM
practice_session	aByAsa_sawra/anuSIlana_sawra#aByAsa_sawra/anuSIlana_sawra#noun#2#RM
pub_session	maxirAlaya_meM_maxyapAna_saBA#maxirAlaya_meM_maxyapAna_saBA#noun#2#RM
quarter_session	wimAhI_bETaka#wimAhI_bETaka#noun#2#RM
query_session	praSna_kAla/praSnowwara_sawra#praSna_kAla/praSnowwara_sawra#noun#2#RM
question_session	SaMkA_samAXAna_sawra#SaMkA_samAXAna_sawra#noun#2#RM
reading_session	paTana_vAcana_sawra#paTana_vAcana_sawra#noun#2#RM
recording_session	rikoYrdiMga_sawra/XvanyAleKana_sawra#rikoYrdiMga_sawra/XvanyAleKana_sawra#noun#2#RM
repeat_session	punarAvqwwi_sawra#punarAvqwwi_sawra#noun#2#RM
review_session	samIkRA_sawra#samIkRA_sawra#noun#2#RM
revision_session	punarIkRaNa_sawra/pariSoXana_sawra#punarIkRaNa_sawra/pariSoXana_sawra#noun#2#RM
road_session	mArga_maXya_saBA/kRewrIya_sawra#mArga_maXya_saBA/kRewrIya_sawra#noun#2#RM
sauna_session	sanA_kakRa_meM_Ayojiwa_saBA#sanA_kakRa_meM_Ayojiwa_saBA#noun#2#RM
seminar_session	saMgoRTI_sawra#saMgoRTI_sawra#noun#2#RM
skill_session	kOSala_sIKane_siKAne_kA_sawra#kOSala_sIKane_siKAne_kA_sawra#noun#2#RM
spring_session	basaMwa_kAlIna_sawra#basaMwa_kAlIna_sawra#noun#2#RM
studio_session	SilpaSAlA_prayoga_sawra#SilpaSAlA_prayoga_sawra#noun#2#RM
study_session	aXyayana_sawra#aXyayana_sawra#noun#2#RM
summer_session	grIRmakAlIna_sawra#grIRmakAlIna_sawra#noun#2#RM
supervision_session	paryavekRaNa_sawra/nirIkRaNa_sawra#paryavekRaNa_sawra/nirIkRaNa_sawra#noun#2#RM
support_session	samarWana_hewu_bETaka/sahAyawA_kAla#samarWana_hewu_bETaka/sahAyawA_kAla#noun#2#RM
swimming_session	wErAkI_hewu_suniSciwa_sawra/wErAkI_kA_samaya#wErAkI_hewu_suniSciwa_sawra/wErAkI_kA_samaya#noun#2#RM
talk_session	vArwA_sawra/samBARaNa_sawra#vArwA_sawra/samBARaNa_sawra#noun#2#RM
taster_session	parIkRaka_sawra/jAzca_sawra#parIkRaka_sawra/jAzca_sawra#noun#2#RM
teaching_session	SikRaNa_sawra/aXyApana_sawra#SikRaNa_sawra/aXyApana_sawra#noun#2#RM
telnet_session	xUraBARa_netavarka_sawra#xUraBARa_netavarka_sawra#noun#2#RM
terminal_session	anwima_sawra#anwima_sawra#noun#2#RM
testing_session	parIkRaNa_sawra/jAzca_hewu_bETaka#parIkRaNa_sawra/jAzca_hewu_bETaka#noun#2#RM
jam_session	BarA_huA_sawra/manoraMjana_saBA#BarA_huA_sawra/manoraMjana_saBA#noun#2#RM
opening_session	prAraMBika_sawra/uxGAtana_sawra#prAraMBika_sawra/uxGAtana_sawra#noun#2#RM
plenary_session	sampUrNa_aXiveSana/samagra_sawra#sampUrNa_aXiveSana/samagra_sawra#noun#2#RM
school_session	vixyAlayIya_aXiveSana/SikRA_sawra#vixyAlayIya_aXiveSana/SikRA_sawra#noun#2#RM
theatre_session	nAtyaSAlA_sawra#nAtyaSAlA_sawra#noun#2#RM
theory_session	sExXAnwika_jFAna_sawra#sExXAnwika_jFAna_sawra#noun#2#RM
therapy_session	upacAra_sawra/cikiwsA_sawra#upacAra_sawra/cikiwsA_sawra#noun#2#RM
toddler_session	nanheM_baccoM_hewu_sawra#nanheM_baccoM_hewu_sawra#noun#2#RM
toolkit_session	upakaraNa_petI_prayoga_sawra#upakaraNa_petI_prayoga_sawra#noun#2#RM
track_session	xOdZa_prawiyogiwA_sawra/anuprayoga_sawra#xOdZa_prawiyogiwA_sawra/anuprayoga_sawra#noun#2#RM
trading_session	vyApArika_saBA#vyApArika_saBA#noun#2#RM
training_session	praSikRaNa_sawra#praSikRaNa_sawra#noun#2#RM
treatment_session	cikiwsA_kAla/upacAra_hewu_bETaka#cikiwsA_kAla/upacAra_hewu_bETaka#noun#2#RM
trial_session	parIkRaNa_sawra/prayoga_kAla#parIkRaNa_sawra/prayoga_kAla#noun#2#RM
twelve_session	eka_xarjana_(bAraha)_sawra#eka_xarjana_(bAraha)_sawra#noun#2#RM
twilight_session	sanXyA_kAlIna_sawra/goXUlI_velA#sanXyA_kAlIna_sawra/goXUlI_velA#noun#2#RM
user_session	upaBokwA_hewu_sawra/prayokwA_kAla#upaBokwA_hewu_sawra/prayokwA_kAla#noun#2#RM
visitor_session	parixarSaka_sawra/paryataka_saBA#parixarSaka_sawra/paryataka_saBA#noun#2#RM
voting_session	mawaxAna_sawra#mawaxAna_sawra#noun#2#RM
weekend_session	sapwAhAnwa_bETaka/sapwAhAnwa_sawra#sapwAhAnwa_bETaka/sapwAhAnwa_sawra#noun#2#RM
weight_session	guNavawwA_sawra/mahawvapUrNa_bETaka#guNavawwA_sawra/mahawvapUrNa_bETaka#noun#2#RM
winter_session	SIwakAlIna_sawra#SIwakAlIna_sawra#noun#2#RM
working_session	kAryaSIla_sawra#kAryaSIla_sawra#noun#2#RM
work_session	kArya_sawra#kArya_sawra#noun#2#RM
workshop_session	kAryaSAlA_sawra#kAryaSAlA_sawra#noun#2#RM
worship_session	ArAXanA_saBA/arcanA_sawra#ArAXanA_saBA/arcanA_sawra#noun#2#RM
writing_session	leKana_sawra#leKana_sawra#noun#2#RM
yoga_session	yoga_sawra#yoga_sawra#noun#2#RM
ability_class	yogyawA_kakRA(praSikRaNa)#yogyawA_kakRA(praSikRaNa)#noun#2#RM
accuracy_class	pariSuxXawA_kakRA#pariSuxXawA_kakRA#noun#2#RM
activation_class	sakriyaNa_kakRA#sakriyaNa_kakRA#noun#2#RM
activity_class	gawiviXi_kakRA#gawiviXi_kakRA#noun#2#RM
adapter_class	anukUlaka_varga#anukUlaka_varga#noun#2#RM
address_class	BARaNa_praSikRaNa#BARaNa_praSikRaNa#noun#2#RM
adult_class	vayaska_varga#vayaska_varga#noun#2#RM
aerobics_class	vAwApekRI_vyAyAma_praSikRaNa#vAwApekRI_vyAyAma_praSikRaNa#noun#2#RM
age_class	prODZa_varga#prODZa_varga#noun#2#RM
aid_class	sahAyawA_varga#sahAyawA_varga#noun#2#RM
application_class	anuprayoga_kakRA#anuprayoga_kakRA#noun#2#RM
art_class	ciwrakArI_kakRA#ciwrakArI_kakRA#noun#2#RM
artisan_class	kArIgara_varga#kArIgara_varga#noun#2#RM
asset_class	sampawwi_varga#sampawwi_varga#noun#2#RM
ballet_class	nqwya_nAtaka_praSikRaNa#nqwya_nAtaka_praSikRaNa#noun#2#RM
base_class	mUla_varga#mUla_varga#noun#2#RM
beginner_class	pravarwaka_varga#pravarwaka_varga#noun#2#RM
beneficiary_class	lABArWI_kakRA#lABArWI_kakRA#noun#2#RM
biology_class	jIvavijFAna_kakRA#jIvavijFAna_kakRA#noun#2#RM
boat_class	nOkA_praSikRaNa#nOkA_praSikRaNa#noun#2#RM
boss_class	mAlika_varga#mAlika_varga#noun#2#RM
bridge_class	wASa_ke_eka_Kela_kA_praSikRaNa#wASa_ke_eka_Kela_kA_praSikRaNa#noun#2#RM
business_class	vyApArika_varga#vyApArika_varga#noun#2#RM
car_class	kAra_varga#kAra_varga#noun#2#RM
carrier_class	saMvAhaka_varga#saMvAhaka_varga#noun#2#RM
cattle_class	paSu(maveSI)_varga#paSu(maveSI)_varga#noun#2#RM
character_class	AcaraNa_kakRA#AcaraNa_kakRA#noun#2#RM
childrens_class	baccoM_kI_kakRA#baccoM_kI_kakRA#noun#2#RM
class_class	uwwama_SreNI(kakRA)#uwwama_SreNI(kakRA)#noun#2#RM
collationelementiterator_class	punarAvarwaka_varga#punarAvarwaka_varga#noun#2#RM
collection_class	saMcayana_varga#saMcayana_varga#noun#2#RM
college_class	mahAvixyAlaya_kakRA#mahAvixyAlaya_kakRA#noun#2#RM
composition_class	saMyojana_kakRA#saMyojana_kakRA#noun#2#RM
computer_class	kampyUtara_kakRA#kampyUtara_kakRA#noun#2#RM
conformation_class	anukUlawA_kakRA#anukUlawA_kakRA#noun#2#RM
conjugacy_class	gaNiwIya_varga#gaNiwIya_varga#noun#2#RM
context_class	saMxarBa_kakRA#saMxarBa_kakRA#noun#2#RM
continuation_class	niraMwarawA_kakRA#niraMwarawA_kakRA#noun#2#RM
conversation_class	saMvAxa_kakRA#saMvAxa_kakRA#noun#2#RM
cookery_class	pAkaSAswra_kakRA#pAkaSAswra_kakRA#noun#2#RM
cooking_class	pAkaSAswra_kakRA#pAkaSAswra_kakRA#noun#2#RM
coordinator_class	saMyojaka_varga#saMyojaka_varga#noun#2#RM
core_class	mUlaBUwa_kakRA#mUlaBUwa_kakRA#noun#2#RM
craft_class	SilpakalA_kakRA#SilpakalA_kakRA#noun#2#RM
cruiser_class	yuxXapowa(bqhawapowa)_SreNI(varga)#yuxXapowa(bqhawapowa)_SreNI(varga)#noun#2#RM
cycling_class	sAikila_calAnA_sIKane_kI_kakRA#sAikila_calAnA_sIKane_kI_kakRA#noun#2#RM
dance_class	nqwya_kakRA#nqwya_kakRA#noun#2#RM
date_class	niyojiwa_BeMta_kakRA#niyojiwa_BeMta_kakRA#noun#2#RM
day_class	xivA_kakRA#xivA_kakRA#noun#2#RM
degree_class	snAwaka_kakRA#snAwaka_kakRA#noun#2#RM
deposit_class	jamA_SreNI#jamA_SreNI#noun#2#RM
design_class	prArupa_kakRA#prArupa_kakRA#noun#2#RM
dialog_class	saMvAxa_kakRA#saMvAxa_kakRA#noun#2#RM
document_class	praleKa_kakRA#praleKa_kakRA#noun#2#RM
drama_class	aBinaya_kakRA#aBinaya_kakRA#noun#2#RM
dreadnought_class	yuxXapowa_varga#yuxXapowa_varga#noun#2#RM
drinking_class	warala_paxArWa_varga#warala_paxArWa_varga#noun#2#RM
driving_class	vAhana_praSikRaNa_kakRA#vAhana_praSikRaNa_kakRA#noun#2#RM
drug_class	ORaXi_varga#ORaXi_varga#noun#2#RM
economy_class	kiPAyawI_SreNI#kiPAyawI_SreNI#noun#2#RM
education_class	SikRA_varga#SikRA_varga#noun#2#RM
enemy_class	Sawru_varga#Sawru_varga#noun#2#RM
enumeration_class	pragaNanA_varga#pragaNanA_varga#noun#2#RM
equivalence_class	samAnawA_SreNI(varga)#samAnawA_SreNI(varga)#noun#2#RM
ethic_class	nIwiSAswra_kakRA#nIwiSAswra_kakRA#noun#2#RM
euroncap_class	yUropa_meM_kAra_niRpAxana_AMkalana_kakRA#yUropa_meM_kAra_niRpAxana_AMkalana_kakRA#noun#2#RM
evaluation_class	mUlyAMkana_SreNI#mUlyAMkana_SreNI#noun#2#RM
evening_class	sAzyakAlIna_kakRA#sAzyakAlIna_kakRA#noun#2#RM
exam_class	parIkRA_kakRa#parIkRA_kakRa#noun#2#RM
example_class	uxAharaNa_SreNI#uxAharaNa_SreNI#noun#2#RM
exception_class	apavAxa_SreNI#apavAxa_SreNI#noun#2#RM
exercise_class	vyAyAma_kakRA#vyAyAma_kakRA#noun#2#RM
fault_class	aparAXa(wruti)_varga(SreNI)#aparAXa(wruti)_varga(SreNI)#noun#2#RM
field_class	kRewra_kArya_kakRA#kRewra_kArya_kakRA#noun#2#RM
figure_class	AMkadZA_SreNI#AMkadZA_SreNI#noun#2#RM
fit_class	svAsWya_kakRA(praSikRaNa)#svAsWya_kakRA(praSikRaNa)#noun#2#RM
fitness_class	svasWawA_kakRA(praSikRaNa)#svasWawA_kakRA(praSikRaNa)#noun#2#RM
form_class	Sabxa_Bexa#Sabxa_Bexa#noun#2#RM
fun_class	manoraMjana_kakRA#manoraMjana_kakRA#noun#2#RM
gentry_class	Baxra_varga#Baxra_varga#noun#2#RM
geography_class	BUgola_kakRA#BUgola_kakRA#noun#2#RM
grade_class	prAWamika_kakRA#prAWamika_kakRA#noun#2#RM
graduating_class	snAwaka_varga#snAwaka_varga#noun#2#RM
grammar_class	vyAkaraNa_kakRA#vyAkaraNa_kakRA#noun#2#RM
group_class	samUha_kakRA#samUha_kakRA#noun#2#RM
gym_class	vyAyAma_kakRA#vyAyAma_kakRA#noun#2#RM
history_class	iwihAsa_kakRA#iwihAsa_kakRA#noun#2#RM
homotopy_class	samAnawA_varga#samAnawA_varga#noun#2#RM
honour_class	prawiRTA_varga#prawiRTA_varga#noun#2#RM
horse_class	aSva_SreNI#aSva_SreNI#noun#2#RM
hospitality_class	awiWi_sawkAra_kakRA#awiWi_sawkAra_kakRA#noun#2#RM
hour_class	GaMte_kI_kakRA#GaMte_kI_kakRA#noun#2#RM
hunter_class	SikArI_varga#SikArI_varga#noun#2#RM
image_class	prawirUpa_kakRA#prawirUpa_kakRA#noun#2#RM
implementation_class	kAryAnvayana_kakRA#kAryAnvayana_kakRA#noun#2#RM
improvisation_class	wAwkAlika_praxarSana_kakRA#wAwkAlika_praxarSana_kakRA#noun#2#RM
infant_class	SiSu_varga#SiSu_varga#noun#2#RM
info_class	sUcanA_kakRA#sUcanA_kakRA#noun#2#RM
integration_class	ekIkaraNa_varga(kakRA)#ekIkaraNa_varga(kakRA)#noun#2#RM
interest_class	aBiruci_kakRA#aBiruci_kakRA#noun#2#RM
investment_class	niveSa_varga#niveSa_varga#noun#2#RM
isomorphism_class	samarUpawA_varga#samarUpawA_varga#noun#2#RM
java_class	jAvA_kakRA#jAvA_kakRA#noun#2#RM
junior_class	kaniRTa_varga#kaniRTa_varga#noun#2#RM
keyword_class	muKya_Sabxa_varga#muKya_Sabxa_varga#noun#2#RM
kilo_class	kilo_varga#kilo_varga#noun#2#RM
laboratory_class	prayogaSAlA_kakRA#prayogaSAlA_kakRA#noun#2#RM
labouting_class	prayogaSAlA_kI_bAhya_kakRA#prayogaSAlA_kI_bAhya_kakRA#noun#2#RM
landlord_class	jamIMxAra_varga#jamIMxAra_varga#noun#2#RM
language_class	BARA_kakRA#BARA_kakRA#noun#2#RM
learningobjectcontext_class	viRaya_aXyayana_sanxarBa_kakRA#viRaya_aXyayana_sanxarBa_kakRA#noun#2#RM
legality_class	vEXawA_SreNI#vEXawA_SreNI#noun#2#RM
level_class	samAnawA_varga#samAnawA_varga#noun#2#RM
library_class	puswakAlaya_kakRA#puswakAlaya_kakRA#noun#2#RM
lipreading_class	oMToM_kI_gawi_(se_bAwa_samaJane)_kA_praSikRaNa#oMToM_kI_gawi_(se_bAwa_samaJane)_kA_praSikRaNa#noun#2#RM
list_class	sUcI_varga#sUcI_varga#noun#2#RM
literacy_class	sAkRarawA_kakRA#sAkRarawA_kakRA#noun#2#RM
literature_class	sAhiwya_kakRA#sAhiwya_kakRA#noun#2#RM
litre_class	lItara_varga#lItara_varga#noun#2#RM
logincontext_class	praveSa_sanxarBa_kakRA#praveSa_sanxarBa_kakRA#noun#2#RM
mainstream_class	muKyaXArA_(viRayaka)_kakRA#muKyaXArA_(viRayaka)_kakRA#noun#2#RM
master_class	snAwakowwara_kakRA/viSiRta_varga#snAwakowwara_kakRA/viSiRta_varga#noun#2#RM
math_class	gaNiwa_kakRA#gaNiwa_kakRA#noun#2#RM
mathematics_class	gaNiwa_kakRA#gaNiwa_kakRA#noun#2#RM
meditation_class	XyAna_kakRA#XyAna_kakRA#noun#2#RM
merchant_class	vyApArI_varga#vyApArI_varga#noun#2#RM
middle_class	maXyama_varga#maXyama_varga#noun#2#RM
minute_class	alpakAlika_kakRA#alpakAlika_kakRA#noun#2#RM
module_class	mApaxaMda_SreNI#mApaxaMda_SreNI#noun#2#RM
morning_class	prAwaHkAlIna_kakRA#prAwaHkAlIna_kakRA#noun#2#RM
movement_class	AMxolana_varga#AMxolana_varga#noun#2#RM
music_class	saMgIwa_kakRA#saMgIwa_kakRA#noun#2#RM
need_class	AvaSyakawA_SreNI#AvaSyakawA_SreNI#noun#2#RM
night_class	rAwrikAlIna_kakRA#rAwrikAlIna_kakRA#noun#2#RM
nilpotency_class	sAmarWyahIna_varga#sAmarWyahIna_varga#noun#2#RM
novel_class	upanyAsa_SreNI#upanyAsa_SreNI#noun#2#RM
novice_class	nOsiKiyA_varga#nOsiKiyA_varga#noun#2#RM
nursery_class	SiSu(narsarI)_kakRA#SiSu(narsarI)_kakRA#noun#2#RM
obesity_class	sWUla_varga#sWUla_varga#noun#2#RM
object_class	vaswu_SreNI#vaswu_SreNI#noun#2#RM
officer_class	aXikArI_varga#aXikArI_varga#noun#2#RM
operator_class	oYparetara_varga#oYparetara_varga#noun#2#RM
opinion_class	aBimawa_varga#aBimawa_varga#noun#2#RM	
painting_class	ciwrakalA_kakRA#ciwrakalA_kakRA#noun#2#RM
pair_class	yugala_kakRA#yugala_kakRA#noun#2#RM
parent_class	aBiBAvaka_varga#aBiBAvaka_varga#noun#2#RM
craft_class	SilpakalA_kakRA#SilpakalA_kakRA#noun#2#RM
peasant_class	kqRaka_varga#kqRaka_varga#noun#2#RM
play_class	prAraMBika_kakRA#prAraMBika_kakRA#noun#2#RM
player_class	KilAdZI_varga#KilAdZI_varga#noun#2#RM
potion_class	ORaXIya_peya_paxArWa_banAne_kA_praSikRaNa#ORaXIya_peya_paxArWa_banAne_kA_praSikRaNa#noun#2#RM
pottery_class	mittI_ke_barwana_banAne_kA_praSikRaNa#mittI_ke_barwana_banAne_kA_praSikRaNa#noun#2#RM
prestige_class	prawiRTiwa_varga#prawiRTiwa_varga#noun#2#RM
principal_class	SAsaka_varga#SAsaka_varga#noun#2#RM
priority_class	varIyawA_SreNI#varIyawA_SreNI#noun#2#RM
problem_class	samasyAwmaka_varga/samasyAwmaka_kakRA#samasyAwmaka_varga/samasyAwmaka_kakRA#noun#2#RM
production_class	uwpAxana_varga#uwpAxana_varga#noun#2#RM
programming_class	progrAma_liKane_kI_kakRA/kramAxeSana_kakRA#progrAma_liKane_kI_kakRA/kramAxeSana_kakRA#noun#2#RM
provider_class	saMBaraka_varga#saMBaraka_varga#noun#2#RM
pullman_class	ArAmaxeya_rela_dibbA_SreNI#ArAmaxeya_rela_dibbA_SreNI#noun#2#RM
rate_class	xara_SreNI#xara_SreNI#noun#2#RM
reception_class	svAgawa_SreNI#svAgawa_SreNI#noun#2#RM
relaxation_class	viSrAma_kakRA#viSrAma_kakRA#noun#2#RM
representation_class	prawiniXiwva_varga/nirUpaNa_kakRA#prawiniXiwva_varga/nirUpaNa_kakRA#noun#2#RM
residue_class	avaSiRta_varga#avaSiRta_varga#noun#2#RM
resource_class	saMsAXana_SreNI#saMsAXana_SreNI#noun#2#RM
revision_class	punarAvalokana_kakRA#punarAvalokana_kakRA#noun#2#RM
revolt_class	vixroha_varga#vixroha_varga#noun#2#RM
road_class	sadZaka_SreNI#sadZaka_SreNI#noun#2#RM
root_class	mUla_kakRA#mUla_kakRA#noun#2#RM
round_class	gola_kakRA#gola_kakRA#noun#2#RM
ruling_class	SAsaka_varga#SAsaka_varga#noun#2#RM
salsa_class	lAwina_amarIkI_nqwya_kakRA#lAwina_amarIkI_nqwya_kakRA#noun#2#RM
samurai_class	jApAnI_sEnya_varga#jApAnI_sEnya_varga#noun#2#RM
school_class	vixyAlaya_kakRA#vixyAlaya_kakRA#noun#2#RM
science_class	vijFAna_kakRA#vijFAna_kakRA#noun#2#RM
seminar_class	saMgoRTI_kakRA#saMgoRTI_kakRA#noun#2#RM
service_class	karmacArI_varga#karmacArI_varga#noun#2#RM
sewing_class	silAI_kakRA(praSikRaNa)#silAI_kakRA(praSikRaNa)#noun#2#RM
sex_class	yOna_kakRA#yOna_kakRA#noun#2#RM
singing_class	gAyana_kakRA(praSikRaNa)#gAyana_kakRA(praSikRaNa)#noun#2#RM
size_class	parimANa_SreNI#parimANa_SreNI#noun#2#RM
skill_class	kOSala_kakRA#kOSala_kakRA#noun#2#RM
slave_class	xAsa(gulAma)_varga#xAsa(gulAma)_varga#noun#2#RM
specialist_class	viSeRajFa_varga#viSeRajFa_varga#noun#2#RM
stat_class	sAMKyikI_kakRA#sAMKyikI_kakRA#noun#2#RM
storage_class	BaMdAraNa_varga#BaMdAraNa_varga#noun#2#RM
stream_class	varga_SreNI#varga_SreNI#noun#2#RM
studio_class	SilpaSAlA_kakRA#SilpaSAlA_kakRA#noun#2#RM
style_class	viSiRtawA_varga#viSiRtawA_varga#noun#2#RM
summer_class	grIRmakAlIna_kakRA#grIRmakAlIna_kakRA#noun#2#RM
taxation_class	kara_nirXAraNa_kakRA#kara_nirXAraNa_kakRA#noun#2#RM
template_class	AxarSa_varga#AxarSa_varga#noun#2#RM
toiling_class	pariSramI_varga#pariSramI_varga#noun#2#RM
trading_class	vyApArika_varga#vyApArika_varga#noun#2#RM
training_class	praSikRaNa_kakRA#praSikRaNa_kakRA#noun#2#RM
transition_class	parivarwana_SreNI#parivarwana_SreNI#noun#2#RM
trial_class	prayawna_kakRA#prayawna_kakRA#noun#2#RM
truck_class	traka_varga#traka_varga#noun#2#RM
use_class	upayoga_kakRA#upayoga_kakRA#noun#2#RM
user_class	prayokwA_varga#prayokwA_varga#noun#2#RM
utility_class	upayogiwA_varga#upayogiwA_varga#noun#2#RM
vehicle_class	vAhana_varga#vAhana_varga#noun#2#RM
view_class	avalokana_kakRA#avalokana_kakRA#noun#2#RM
voyager_class	samuxrI_paryataka_SreNI#samuxrI_paryataka_SreNI#noun#2#RM
warrior_class	sEnika_varga#sEnika_varga#noun#2#RM
way_class	sAXana_varga#sAXana_varga#noun#2#RM
weekend_class	sapwAhAMwa_kakRA#sapwAhAMwa_kakRA#noun#2#RM
weight_class	KeloM_meM_SArIrika_BArAnusAra_sparXA_SreNI#KeloM_meM_SArIrika_BArAnusAra_sparXA_SreNI#noun#2#RM
widget_class	viSiRta_maSIna_SreNI#viSiRta_maSIna_SreNI#noun#2#RM
window_class	kampyUtara_progrAmiMga_meM_mUla_sixXAnwa_kI_SreNI#kampyUtara_progrAmiMga_meM_mUla_sixXAnwa_kI_SreNI#noun#2#RM
word_class	Sabxa_varga#Sabxa_varga#noun#2#RM
work_class	kAmakAjI_varga#kAmakAjI_varga#noun#2#RM
working_class	SramajIvI_varga/majaxUra_varga#SramajIvI_varga/majaxUra_varga#noun#2#RM
world_class	sarvowwama_SreNI#sarvowwama_SreNI#adjective#2#RM
writing_class	leKana_kakRA#leKana_kakRA#noun#2#RM
year_class	vArRika_kakRA#vArRika_kakRA#noun#2#RM
yoga_class	yoga_kakRA#yoga_kakRA#noun#2#RM
bow_end	XanuRa_kA_aMwima_BAga(sirA)#XanuRa_kA_aMwima_BAga(sirA)#noun#2#RM
boycott_end	bahiRkAra_samApwi#bahiRkAra_samApwi#noun#2#RM
brake_end	gawiroXaka(AroXa)_sImA#gawiroXaka(AroXa)_sImA#noun#2#RM
breech_end	banxUka_kI_nAlapqRTa_kA_sirA#banxUka_kI_nAlapqRTa_kA_sirA#noun#2#RM
brick_end	IMta_kA_konA#IMta_kA_konA#noun#2#RM
bridge_end	sewu_sImA(samApwi)#sewu_sImA(samApwi)#noun#2#RM
buckle_end	bakasuA(bakkala)_kA_Cora#bakasuA(bakkala)_kA_Cora#noun#2#RM
budget_end	Aya_vyaya_leKA(bajata)_samApwi#Aya_vyaya_leKA(bajata)_samApwi#noun#2#RM
burning_end	xAhaka(wApaka)_anwa(samApwi)#xAhaka(wApaka)_anwa(samApwi)#noun#2#RM
business_end	vyApAra_uxxeSya#vyApAra_uxxeSya#noun#2#RM
cab_end	tEksI_sImA/gAdZI_prayojana#tEksI_sImA/gAdZI_prayojana#noun#2#RM
cable_end	sanxeSa_wAra_sImA(samApwi)#sanxeSa_wAra_sImA(samApwi)#noun#2#RM
can_end	kanaswara_sImA#kanaswara_sImA#noun#2#RM
cantilever_end	Bujowwolaka_ASraya#Bujowwolaka_ASraya#noun#2#RM
carboxyl_end	kArbanika_amlIya_wawwva_samApwi#kArbanika_amlIya_wawwva_samApwi#noun#2#RM
career_end	jIvikA_samApwi/jIvana_vqwwi_sImA#jIvikA_samApwi/jIvana_vqwwi_sImA#noun#2#RM
cast_end	BUmikA_samApwi/sAzce_kA_sirA#BUmikA_samApwi/sAzce_kA_sirA#noun#2#RM
celebration_end	uwsava(samAroha)_samApwi#uwsava(samAroha)_samApwi#noun#2#RM
cent_end	PrAMsIsI_muxrA_samApwi/sikkA_(SawAMSa)_sImA#PrAMsIsI_muxrA_samApwi/sikkA_(SawAMSa)_sImA#noun#2#RM
chancel_end	girajAGara_ke_pUrvI_BAga_kA_uxxeSya#girajAGara_ke_pUrvI_BAga_kA_uxxeSya#noun#2#RM
chapter_end	aXyAya_samApwi#aXyAya_samApwi#noun#2#RM
chromosome_end	guNasUwra_samApwi(sImA)#guNasUwra_samApwi(sImA)#noun#2#RM
church_end	girajAGara_sImA#girajAGara_sImA#noun#2#RM
cigarette_end	sigareta_kA_sirA#sigareta_kA_sirA#noun#2#RM
city_end	nagara_sImA#nagara_sImA#noun#2#RM
claw_end	paMje_kA_anwima_BAga/caMgula_samApwi#paMje_kA_anwima_BAga/caMgula_samApwi#noun#2#RM
cleric_end	XArmika_newA_kA_uxxeSya#XArmika_newA_kA_uxxeSya#noun#2#RM
client_end	grAhaka_uxxeSya/yajamAna_aBiprAya/muvakkila_aBiprAya#grAhaka_uxxeSya/yajamAna_aBiprAya/muvakkila_aBiprAya#noun#2#RM
clubhouse_end	klaba_saxana_uxxeSya/saBA_saxana_sImA#klaba_saxana_uxxeSya/saBA_saxana_sImA#noun#2#RM
code_end	saMkewa_samApwi/sAMkewika_aMka_prayojana#saMkewa_samApwi/sAMkewika_aMka_prayojana#noun#2#RM
cod_end	bIja_koRa_samApwi#bIja_koRa_samApwi#noun#2#RM
com_end	(sArWaka)_saMkewa_aBiprAya#(sArWaka)_saMkewa_aBiprAya#noun#2#RM
commodity_end	upayogI_vaswu(sAmagrI)_samApwi#upayogI_vaswu(sAmagrI)_samApwi#noun#2#RM
comparison_end	wulanA_kA_anwa#wulanA_kA_anwa#noun#2#RM
consultation_end	parAmarSa_aBiprAya/vimarSa_samApwi#parAmarSa_aBiprAya/vimarSa_samApwi#noun#2#RM
consumer_end	upaBokwA_uxxeSya#upaBokwA_uxxeSya#noun#2#RM
continent_end	mahAxvIpa_sImA#mahAxvIpa_sImA#noun#2#RM
copper_end	wAmra_samApwi/wAMbe_kA_ASraya#wAmra_samApwi/wAMbe_kA_ASraya#noun#2#RM
corridor_end	galiyAre_kA_anwa(sImA)#galiyAre_kA_anwa(sImA)#noun#2#RM
cost_end	mUlya_sImA(samApwi)#mUlya_sImA(samApwi)#noun#2#RM
country_end	rARtra_sImA#rARtra_sImA#noun#2#RM
course_end	pATyakrama_samApwi#pATyakrama_samApwi#noun#2#RM
crew_end	karmI_xala_uxxeSya#karmI_xala_uxxeSya#noun#2#RM
customer_end	grAhaka_aBiprAya#grAhaka_aBiprAya#noun#2#RM
cut_end	aMwima_sImA/wIkRNa_sirA#aMwima_sImA/wIkRNa_sirA#noun#2#RM
dam_end	bAzXa_sImA#bAzXa_sImA#noun#2#RM
database_end	AMkadZA_saMcaya_pariNAma#AMkadZA_saMcaya_pariNAma#noun#2#RM
day_end	niyawa_samaya_samApwi/xivasa_pariNAma(samApwi)#niyawa_samaya_samApwi/xivasa_pariNAma(samApwi)#noun#2#RM
delay_end	vilamba_sImA(samApwi)/vilambiwa_kArya_sImA#vilamba_sImA(samApwi)/vilambiwa_kArya_sImA#noun#2#RM
delivery_end	viwaraNa_uxxeSya/supurxagI_sImA#viwaraNa_uxxeSya/supurxagI_sImA#noun#2#RM
departure_end	prasWAna_samApwi/prayANa_prayojana#prasWAna_samApwi/prayANa_prayojana#noun#2#RM
design_end	aBikalpanA_ASraya/rUpareKA_uxxeSya#aBikalpanA_ASraya/rUpareKA_uxxeSya#noun#2#RM
designer_end	aBikalpaka_uxxeSya#aBikalpaka_uxxeSya#noun#2#RM
development_end	vikAsa_Xyeya/parivqxXi_sImA#vikAsa_Xyeya/parivqxXi_sImA#noun#2#RM
diameter_end	vyAsa(cOdZAI)_kA_anwima_sirA#vyAsa(cOdZAI)_kA_anwima_sirA#noun#2#RM
discount_end	CUta(riyAyawa)_samApwi#CUta(riyAyawa)_samApwi#noun#2#RM
discretion_end	kArya_svAXInawA_aBiprAya/svAwanwrya_samApwi#kArya_svAXInawA_aBiprAya/svAwanwrya_samApwi#noun#2#RM
door_end	xaravAje_kA_Cora#xaravAje_kA_Cora#noun#2#RM
drive_end	gAdZI_ke_paWa_kI_sImA/prabala_preraNA_uxxeSya#gAdZI_ke_paWa_kI_sImA/prabala_preraNA_uxxeSya#noun#2#RM
economy_end	arWa_vyavasWA_uxxeSya/arWa_prabanXana_aBiprAya#arWa_vyavasWA_uxxeSya/arWa_prabanXana_aBiprAya#noun#2#RM
embankment_end	wata_baMXana_sImA/bAzXa_bAzXane_kA_uxxeSya#wata_baMXana_sImA/bAzXa_bAzXane_kA_uxxeSya#noun#2#RM
employer_end	niyojaka_aBiprAya/niyokwA_prayojana#niyojaka_aBiprAya/niyokwA_prayojana#noun#2#RM
end_end	sImA_samApwi#sImA_samApwi#noun#2#RM
engine_end	iMjana_kA_Cora#iMjana_kA_Cora#noun#2#RM
entrance_end	praveSa_sImA(samApwi)/xvAra_sImA#praveSa_sImA(samApwi)/xvAra_sImA#noun#2#RM
event_end	kAryakrama_samApwi#kAryakrama_samApwi#noun#2#RM
exhaust_end	pariSrama_pariNAma/nikAsa_samApwi#pariSrama_pariNAma/nikAsa_samApwi#noun#2#RM
fact_end	waWya_aBiprAya/yaWArWa_prayojana#waWya_aBiprAya/yaWArWa_prayojana#noun#2#RM
film_end	calaciwra(PZilma)_samApwi#calaciwra(PZilma)_samApwi#noun#2#RM
finger_end	aMgulI_kA_sirA#aMgulI_kA_sirA#noun#2#RM
finish_end	pariRkaraNa_samApwi/samApana_uxxeSya#pariRkaraNa_samApwi/samApana_uxxeSya#noun#2#RM
firebox_end	agni_kakRa_sImA/kroXa_samApwi#agni_kakRa_sImA/kroXa_samApwi#noun#2#RM
firing_end	golAbArI_samApwi#golAbArI_samApwi#noun#2#RM
flywheel_end	yanwra_cakra_kA_sirA#yanwra_cakra_kA_sirA#noun#2#RM
foot_end	pAzva_kA_Cora#pAzva_kA_Cora#noun#2#RM
fore_end	pUrva_pariNAma/agra_sImA#pUrva_pariNAma/agra_sImA#noun#2#RM
frame_end	cOKata(Prema)_kA_sirA#cOKata(Prema)_kA_sirA#noun#2#RM
freedom_end	svawanwrawA_samApwi/svawanwrawA_Xyeya#svawanwrawA_samApwi/svawanwrawA_Xyeya#noun#2#RM
frequency_end	Avqwwi_samApwi#Avqwwi_samApwi#noun#2#RM
game_end	Kela_samApwi#Kela_samApwi#noun#2#RM
goto_end	goto(kamputara_kI_BARA_viSeRa)_aBiprAya#goto(kamputara_kI_BARA_viSeRa)_aBiprAya#noun#2#RM
grant_end	anuxAna_samApwi#anuxAna_samApwi#noun#2#RM
grip_end	pakadZa_samApwi/xabAva_sImA#pakadZa_samApwi/xabAva_sImA#noun#2#RM
hand_end	hAWa_kA_anwima_BAga/aXikAra_samApwi#hAWa_kA_anwima_BAga/aXikAra_samApwi#noun#2#RM
handlebar_end	hEMdala_kI_CadZI_kA_sirA#hEMdala_kI_CadZI_kA_sirA#noun#2#RM
harbour_end	banxaragAha_sImA#banxaragAha_sImA#noun#2#RM
harvest_end	Pasala_pariNAma#Pasala_pariNAma#noun#2#RM
head_end	SIrRa_sirA/pramuKa_prayojana/kenxrIya_niyanwraNa(kakRa)#SIrRa_sirA/pramuKa_prayojana/kenxrIya_niyanwraNa(kakRa)#noun#2#RM
headstock_end	muKya_sAmagrI_samApwi#muKya_sAmagrI_samApwi#noun#2#RM
highlight_end	viSiRtawA_samApwi/cinhAMkana_prayojana#viSiRtawA_samApwi/cinhAMkana_prayojana#noun#2#RM
hinge_end	kulAbe_kA_sirA#kulAbe_kA_sirA#noun#2#RM
hinner_end	rukAvata(prawiroXa)_samApwi#rukAvata(prawiroXa)_samApwi#noun#2#RM
home_end	gqha_sImA#gqha_sImA#noun#2#RM
hood_end	PaNa_kA_agra_BAga/topI_kA_sirA#PaNa_kA_agra_BAga/topI_kA_sirA#noun#2#RM
hospital_end	cikiwsAlaya_sImA#cikiwsAlaya_sImA#noun#2#RM
hour_end	samaya_samApwi#samaya_samApwi#noun#2#RM
hub_end	kenxra_parisImA#kenxra_parisImA#noun#2#RM
increase_end	viswAra_sImA#viswAra_sImA#noun#2#RM
inlet_end	praveSa_xvAra_sImA#praveSa_xvAra_sImA#noun#2#RM
input_end	niveSa_sImA(samApwi)#niveSa_sImA(samApwi)#noun#2#RM
intake_end	grahaNa_sImA(samApwi)#grahaNa_sImA(samApwi)#noun#2#RM
interest_end	byAja_sImA(samApwi)/aBiruci_samApwi#byAja_sImA(samApwi)/aBiruci_samApwi#noun#2#RM
keyword_end	saMkewa_Sabxa(muKya_Sabxa)_aBiprAya#saMkewa_Sabxa(muKya_Sabxa)_aBiprAya#noun#2#RM
kitchen_end	rasoIGara_kA_Cora(konA)#rasoIGara_kA_Cora(konA)#noun#2#RM
land_end	rARtra_sImA/ilAkA_samApwi#rARtra_sImA/ilAkA_samApwi#noun#2#RM
line_end	paMkwi_samApwi#paMkwi_samApwi#noun#2#RM
load_end	BAra_sImA/mAla_samApwi#BAra_sImA/mAla_samApwi#noun#2#RM
lunch_end	xopahara_ke_Bojana(laMca)_kI_samApwi#xopahara_ke_Bojana(laMca)_kI_samApwi#noun#2#RM
luxury_end	vilAsiwA_samApwi/ArAma_sImA#vilAsiwA_samApwi/ArAma_sImA#noun#2#RM
macro_end	sWUla_pariNAma#sWUla_pariNAma#noun#2#RM
madness_end	pAgalapana_samApwi/kroXa_sImA#pAgalapana_samApwi/kroXa_sImA#noun#2#RM
majority_end	bahumawa_kA_pariNAma#bahumawa_kA_pariNAma#noun#2#RM
marriage_end	vivAha_vicCexa/vivAha_pariNAma#vivAha_vicCexa/vivAha_pariNAma#noun#2#RM
metal_end	XAwu_pariNAma#XAwu_pariNAma#noun#2#RM
mhz_end	megAhartjZa(vixyuw_mApana_ikAI)_sImA#megAhartjZa(vixyuw_mApana_ikAI)_sImA#noun#2#RM
minus_end	alpawA_sImA/nakArAwmakawA_samApwi#alpawA_sImA/nakArAwmakawA_samApwi#noun#2#RM
money_end	muxrA_sImA/Xana_samApwi#muxrA_sImA/Xana_samApwi#noun#2#RM
month_end	mAsa(mAha)_kA_anwa#mAsa(mAha)_kA_anwa#noun#2#RM
mouthpiece_end	muhanAla(eka_prakAra_kA_vAxya)_kA_sirA#muhanAla(eka_prakAra_kA_vAxya)_kA_sirA#noun#2#RM
music_end	saMgIwa_samApwi#saMgIwa_samApwi#noun#2#RM
muzzle_end	baMxUka_kA_anwima_sirA#baMxUka_kA_anwima_sirA#noun#2#RM
name_end	prawiRTA_samApwi/parivAra_sImA#prawiRTA_samApwi/parivAra_sImA#noun#2#RM
neck_end	kaNTa_sImA(Cora)#kaNTa_sImA(Cora)#noun#2#RM
news_end	samAcAra_samApwi/sUcanA_samApwi#samAcAra_samApwi/sUcanA_samApwi#noun#2#RM
nhs_end	rARtrIya_svAsWya_sevA_samApwi(pariNAma)#rARtrIya_svAsWya_sevA_samApwi(pariNAma)#noun#2#RM
nob_end	XanADya_vyakwi_kA_aBiprAya#XanADya_vyakwi_kA_aBiprAya#noun#2#RM
none_end	asaMBava_pariNAma/vAswavika_aBiprAya#asaMBava_pariNAma/vAswavika_aBiprAya#noun#2#RM
north_end	uwwara_xiSA_kA_Cora#uwwara_xiSA_kA_Cora#noun#2#RM
nose_end	nAka_kA_anwima_BAga#nAka_kA_anwima_BAga#noun#2#RM
nothing_end	SUnya_samApwi/SUnya-pariNAma#SUnya_samApwi/SUnya-pariNAma#noun#2#RM
object_end	prayojana_samApwi/lakRya_prApwi#prayojana_samApwi/lakRya_prApwi#noun#2#RM
offer_end	saswI_bikrI_samApwi/praswAva_samApwi#saswI_bikrI_samApwi/praswAva_samApwi#noun#2#RM
office_end	kAryAlaya_uxxeSya/kAryAlaya_samApwi#kAryAlaya_uxxeSya/kAryAlaya_samApwi#noun#2#RM
operation_end	sAmarika_gawiviXi_samApwi/paricAlana_anwa(pariNAma)/Salya_cikiwsA_samApwi#sAmarika_gawiviXi_samApwi/paricAlana_anwa(pariNAma)/Salya_cikiwsA_samApwi#noun#2#RM
outlet_end	nikAsa_sImA/visarjana_kenxra_samApwi#nikAsa_sImA/visarjana_kenxra_samApwi#noun#2#RM
output_end	uwpAxana_sImA/nirgama_samApwi#uwpAxana_sImA/nirgama_samApwi#noun#2#RM
oxygen_end	AksIjana_samApwi#AksIjana_samApwi#noun#2#RM
page_end	pqRTa_samApwi#pqRTa_samApwi#noun#2#RM
pair_end	yugala_samApwi/yugma_pariNAma#yugala_samApwi/yugma_pariNAma#noun#2#RM
parking_end	pArkiMga_sImA#pArkiMga_sImA#noun#2#RM
pavilion_end	KemA(pEviliyana)_sImA#KemA(pEviliyana)_sImA#noun#2#RM
people_end	prajA_kA_uxxeSya/rARtra_sImA/samAja_kA_uxxeSya#prajA_kA_uxxeSya/rARtra_sImA/samAja_kA_uxxeSya#noun#2#RM
performance_end	praxarSana_pariNAma/niRpAxana_sImA#praxarSana_pariNAma/niRpAxana_sImA#noun#2#RM
period_end	avaXi_samApwi(sImA)#avaXi_samApwi(sImA)#noun#2#RM
pier_end	GAta(powaGAta)_samApwi(sImA)#GAta(powaGAta)_samApwi(sImA)#noun#2#RM
pin_end	pina_kA_sirA/suI_kI_noka#pina_kA_sirA/suI_kI_noka#noun#2#RM
pipe_end	pAipa_kA_sirA/sigAra_samApwi#pAipa_kA_sirA/sigAra_samApwi#noun#2#RM
plastic_end	plAstika_samApwi(pariNAma)#plAstika_samApwi(pariNAma)#noun#2#RM
platform_end	pletaPArma(unnawa_sWAna)_sImA#pletaPArma(unnawa_sWAna)_sImA#noun#2#RM
play_end	nAtaka_samApwi/Kela_samApwi#nAtaka_samApwi/Kela_samApwi#noun#2#RM
point_end	biMxu_samApwi(sImA)/muxxA_pariNAma#biMxu_samApwi(sImA)/muxxA_pariNAma#noun#2#RM
pole_end	KamBA_samApwi/swamBa_sImA#KamBA_samApwi/swamBa_sImA#noun#2#RM
pregnancy_end	garBAvasWA_pariNAma#garBAvasWA_pariNAma#noun#2#RM
premium_end	aXimUlya_sImA/prImiyama_samApwi#aXimUlya_sImA/prImiyama_samApwi#noun#2#RM
production_end	uwpAxana_samApwi/uwpAxa_sImA/praswuwikaraNa_aBiprAya#uwpAxana_samApwi/uwpAxa_sImA/praswuwikaraNa_aBiprAya#noun#2#RM
project_end	pariyojanA_samApwi#pariyojanA_samApwi#noun#2#RM
quality_end	guNavawwA_pariNAma#guNavawwA_pariNAma#noun#2#RM
quarter_end	cOWAI_pariNAma/cawurWAMSa_samApwi(sImA)#cOWAI_pariNAma/cawurWAMSa_samApwi(sImA)#noun#2#RM
race_end	xOdZa_sImA/sparXA_samApwi#xOdZa_sImA/sparXA_samApwi#noun#2#RM
railway_end	rela_paWa_samApwi/relamArga_sImA#rela_paWa_samApwi/relamArga_sImA#noun#2#RM
reading_end	aXyayana_samApwi/vAcana_aBiprAya#aXyayana_samApwi/vAcana_aBiprAya#noun#2#RM
reality_end	yaWArWawA_samApwi/vAswavika_pariNAma#yaWArWawA_samApwi/vAswavika_pariNAma#noun#2#RM
receiver_end	gqhIwA_uxxeSya/prApwakarwA_sImA#gqhIwA_uxxeSya/prApwakarwA_sImA#noun#2#RM
reception_end	svAgawa_samApwi/aBigrahaNa_sImA#svAgawa_samApwi/aBigrahaNa_sImA#noun#2#RM
repeat_end	punarAvqwwi_samApwi#punarAvqwwi_samApwi#noun#2#RM
report_end	vivaraNa_samApwi#vivaraNa_samApwi#noun#2#RM
reserve_end	ArakRiwa_sImA/prawibaMXa_samApwi#ArakRiwa_sImA/prawibaMXa_samApwi#noun#2#RM
return_end	prawigama_sImA/prawilABa_pariNAma#prawigama_sImA/prawilABa_pariNAma#noun#2#RM
right_end	xAhinI_sirA/uciwa_pariNAma#xAhinI_sirA/uciwa_pariNAma#noun#2#RM
river_end	naxI_samApwi(sImA)/xariyA_kA_anwima_Cora#naxI_samApwi(sImA)/xariyA_kA_anwima_Cora#noun#2#RM
road_end	sadZaka_sImA/mArga_samApwi#sadZaka_sImA/mArga_samApwi#noun#2#RM
rock_end	cattAna_kI_Cora(sImA)#cattAna_kI_Cora(sImA)#noun#2#RM
root_end	mUla_pariNAma/jadZa_samApwi#mUla_pariNAma/jadZa_samApwi#noun#2#RM
round_end	vqwwa_samApwi/Avarwana_sImA#vqwwa_samApwi/Avarwana_sImA#noun#2#RM
row_end	paMkwi_samApwi(sImA)#paMkwi_samApwi(sImA)#noun#2#RM
runway_end	vimAna_(xOdZa)_pattI_samApwi(sImA)#vimAna_(xOdZa)_pattI_samApwi(sImA)#noun#2#RM
school_end	vixyAlaya_sImA/SikRaNa_samApwi#vixyAlaya_sImA/SikRaNa_samApwi#noun#2#RM
sea_end	samuxra_sImA/samuxra_ke_anwima_kinAre_waka#samuxra_sImA/samuxra_ke_anwima_kinAre_waka#noun#2#RM
season_end	qwu(mOsama)_samApwi#qwu(mOsama)_samApwi#noun#2#RM
section_end	saMBAga_sImA/KaNda_samApwi#saMBAga_sImA/KaNda_samApwi#noun#2#RM
selection_end	cayana_samApwi/saMkalana_pariNAma#cayana_samApwi/saMkalana_pariNAma#noun#2#RM
sentence_end	vAkya_samApwi#vAkya_samApwi#noun#2#RM
server_end	sarvara_sImA/sevaka/sevikA_aBiprAya#sarvara_sImA/sevaka/sevikA_aBiprAya#noun#2#RM
service_end	sevA_samApwi/sevA_nivqwwi/kArya_samApwi#sevA_samApwi/sevA_nivqwwi/kArya_samApwi#noun#2#RM
session_end	sawra_samApwi(sImA)#sawra_samApwi(sImA)#noun#2#RM
shaft_end	BAle_ke_daMde_kA_sirA/wIra_kA_sirA#BAle_ke_daMde_kA_sirA/wIra_kA_sirA#noun#2#RM
shore_end	wata_sImA#wata_sImA#noun#2#RM
similarity_end	saxqSyawA_pariNAma/sAxqSya_samApwi#saxqSyawA_pariNAma/sAxqSya_samApwi#noun#2#RM
smokebox_end	XUmrapetikA_kA_anwima_BAga#XUmrapetikA_kA_anwima_BAga#noun#2#RM
software_end	soYPtaveyara_samApwi#soYPtaveyara_samApwi#noun#2#RM
south_end	xakRiNI_Cora#xakRiNI_Cora#noun#2#RM
speech_end	vyAKyAna(BARaNa)_samApwi#vyAKyAna(BARaNa)_samApwi#noun#2#RM
spindle_end	XurI_samApwi/wanwu_sImA#XurI_samApwi/wanwu_sImA#noun#2#RM
stalk_end	daMTala_sirA/dAlI_kA_Cora#daMTala_sirA/dAlI_kA_Cora#noun#2#RM
start_end	prAraMBa_samApwi/samaya_sImA#prAraMBa_samApwi/samaya_sImA#noun#2#RM
station_end	steSana_sImA/avasWA_pariNAma#steSana_sImA/avasWA_pariNAma#noun#2#RM
stem_end	mUla_pariNAma/wanA_samApwi#mUla_pariNAma/wanA_samApwi#noun#2#RM
storey_end	maMjila_sImA/wallA_samApwi#maMjila_sImA/wallA_samApwi#noun#2#RM
story_end	kaWA_samApwi/vqwAnwa_pariNAma#kaWA_samApwi/vqwAnwa_pariNAma#noun#2#RM
stub_end	TUzTa_kA_sirA/tukafe_kI_sImA#TUzTa_kA_sirA/tukafe_kI_sImA#noun#2#RM
student_end	aXyewA_aBiprAya/vixyArWI_sImA#aXyewA_aBiprAya/vixyArWI_sImA#noun#2#RM
subgroup_end	upasamuxAya_sImA/upavarga_pariNAma/upaxala_samApwi#upasamuxAya_sImA/upavarga_pariNAma/upaxala_samApwi#noun#2#RM
supply_end	ApUrwi_sImA/pUrwi_pariNAma#ApUrwi_sImA/pUrwi_pariNAma#noun#2#RM
tailstock_end	KarAxa_AXAra_kA_sirA/muKya_BaNdAra_sImA#KarAxa_AXAra_kA_sirA/muKya_BaNdAra_sImA#noun#2#RM
tale_end	upAKyAna(kahAnI)_samApwi#upAKyAna(kahAnI)_samApwi#noun#2#RM
technology_end	wakanIkI_anwa/wakanIkI_sImA/wakanIkI_pariNAma#wakanIkI_anwa/wakanIkI_sImA/wakanIkI_pariNAma#noun#2#RM
telephoto_end	xUraciwra_sImA#xUraciwra_sImA#noun#2#RM
tenancy_end	kirAexArI_kI_avaXi_samApwi#kirAexArI_kI_avaXi_samApwi#noun#2#RM
terminal_end	tarminala_samApwi/anwima_sWAna_samApwi#tarminala_samApwi/anwima_sWAna_samApwi#noun#2#RM
theatre_end	nAtyaSAlA_uxxeSya/raMgaSAlA_sImA#nAtyaSAlA_uxxeSya/raMgaSAlA_sImA#noun#2#RM
thermostat_end	wApa_niyanwraNa_sImA/wApa_niyawikaraNa_pariNAma#wApa_niyanwraNa_sImA/wApa_niyawikaraNa_pariNAma#noun#2#RM
thisweek_end	varwamAna_sapwAha_samApwi(anwa)#varwamAna_sapwAha_samApwi(anwa)#noun#2#RM
tip_end	saMkewa_samApwi/suJAva_sImA#saMkewa_samApwi/suJAva_sImA#noun#2#RM
toe_end	pAzva_ke_azgUTe_kA_sirA#pAzva_ke_azgUTe_kA_sirA#noun#2#RM
tower_end	mInAra_samApwi(sImA)#mInAra_samApwi(sImA)#noun#2#RM
town_end	nagara_sImA#nagara_sImA#noun#2#RM
tree_end	vqkRa_sImA/vaMSa_samApwi#vqkRa_sImA/vaMSa_samApwi#noun#2#RM
trend_end	pracalana_samApwi/pravAha_sImA(pariNAma)#pracalana_samApwi/pravAha_sImA(pariNAma)#noun#2#RM
tube_end	tyUba(nalI)_kA_sirA#tyUba(nalI)_kA_sirA#noun#2#RM
upmarket_end	ucca_Aya_varga_hewu_nirmiwa_bAjAra_kA_uxxeSya#ucca_Aya_varga_hewu_nirmiwa_bAjAra_kA_uxxeSya#noun#2#RM
upslope_end	caDAva_sImA/DalAna_samApwi#caDAva_sImA/DalAna_samApwi#noun#2#RM
user_end	upayogakarwA_aBiprAya/prayokwA_uxxeSya#upayogakarwA_aBiprAya/prayokwA_uxxeSya#noun#2#RM
value_end	mUlya_samApwi/upayogiwA_sImA/wAwparya_pariNAma#mUlya_samApwi/upayogiwA_sImA/wAwparya_pariNAma#noun#2#RM
village_end	grAma_sImA#grAma_sImA#noun#2#RM
voltage_end	volteja(vixyuwa_saMcAlana_Sakwi)_sImA#volteja(vixyuwa_saMcAlana_Sakwi)_sImA#noun#2#RM
volume_end	wIvrawA_samApwi/viswAra_sImA#wIvrawA_samApwi/viswAra_sImA#noun#2#RM
voting_end	mawaxAna_samApwi/mawaxAna_uxxeSya(pariNAma)#mawaxAna_samApwi/mawaxAna_uxxeSya(pariNAma)#noun#2#RM
war_end	yuxXa_samApwi#yuxXa_samApwi#noun#2#RM
week_end	sapwAha_anwa(sapwAhAnwa)#sapwAha_anwa(sapwAhAnwa)#noun#2#RM
weight_end	BArIpana_samApwi/BAra_sImA/xabAva_pariNAma#BArIpana_samApwi/BAra_sImA/xabAva_pariNAma#noun#2#RM
west_end	paScimI_sirA(BAga)#paScimI_sirA(BAga)#noun#2#RM
winch_end	caraKI(GiranI)_kA_sirA(Cora)#caraKI(GiranI)_kA_sirA(Cora)#noun#2#RM
windmill_end	pavana_cakkI_kA_sirA(SIrRa_BAga)#pavana_cakkI_kA_sirA(SIrRa_BAga)#noun#2#RM
window_end	KidZakI_kA_Cora/vAwAyana_samApwi(sImA)#KidZakI_kA_Cora/vAwAyana_samApwi(sImA)#noun#2#RM
wits_end	buxXi_sImA/viveka_samApwi#buxXi_sImA/viveka_samApwi#noun#2#RM
yarn_end	XAge_kA_sirA/wAra_samApwi(sImA)#XAge_kA_sirA/wAra_samApwi(sImA)#noun#2#RM
year_end	varRa_samApwi#varRa_samApwi#noun#2#RM
advertising_engine	vijFApana_sAXana(yukwi)/vijFApana_maSIna#vijFApana_sAXana(yukwi)/vijFApana_maSIna#noun#2#RM
aero_engine	vAyuyAna_sambanXI_yanwra(maSIna)#vAyuyAna_sambanXI_yanwra(maSIna)#noun#2#RM
aeroplane_engine	vAyuyAna_iMjana(yanwra)#vAyuyAna_iMjana(yanwra)#noun#2#RM
animation_engine	jIvanwa_sAXana/sajIva_sAXana(yukwi)#jIvanwa_sAXana/sajIva_sAXana(yukwi)#noun#2#RM
antivirus_engine	viRANu_prawiroXa_yukwi(sAXana)#viRANu_prawiroXa_yukwi(sAXana)#noun#2#RM
attitude_engine	pravqwwi_preraka(sAXana)/DaMga(prakAra)_yukwi#pravqwwi_preraka(sAXana)/DaMga(prakAra)_yukwi#noun#2#RM
beam_engine	saMkewana_yanwra#saMkewana_yanwra#noun#2#RM
boat_engine	nOkA(nAva)_iMjana(calAne_kA_yanwra)#nOkA(nAva)_iMjana(calAne_kA_yanwra)#noun#2#RM
booking_engine	ArakRaNa_karane_kA_sAXana(maSIna)#ArakRaNa_karane_kA_sAXana(maSIna)#noun#2#RM
camshaft_engine	kEma_se_saMlagna_huA_yanwra(maSIna)#kEma_se_saMlagna_huA_yanwra(maSIna)#noun#2#RM
capacity_engine	kRamawA_yanwra/kRamawA(viSeRa_Sakwi)_kA_sAXana#kRamawA_yanwra/kRamawA(viSeRa_Sakwi)_kA_sAXana#noun#2#RM
combustion_engine	xahana_iMjana/jalAne_kI_maSIna#xahana_iMjana/jalAne_kI_maSIna#noun#2#RM
control_engine	niyanwraNa_yanwra(sAXana)#niyanwraNa_yanwra(sAXana)#noun#2#RM
database_engine	detAbesa(AzkadZA_AXAra)_yanwra#detAbesa(AzkadZA_AXAra)_yanwra#noun#2#RM
datum_engine	AzkadZA_(raKane_kA)_yanwra/praxawwa_sAXana#AzkadZA_(raKane_kA)_yanwra/praxawwa_sAXana#noun#2#RM
design_engine	dijZAina_maSIna/aBikalpa(akAra)_yanwra#dijZAina_maSIna/aBikalpa(akAra)_yanwra#noun#2#RM
display_engine	praxarSana_sAXana(maSIna)#praxarSana_sAXana(maSIna)#noun#2#RM
email_engine	Imela(vixyuw_vinimaya)_sAXana#Imela(vixyuw_vinimaya)_sAXana#noun#2#RM
event_engine	kAryakrama_saMcAlaka/vqwAnwa(GatanA)_yukwi#kAryakrama_saMcAlaka/vqwAnwa(GatanA)_yukwi#noun#2#RM
expansion_engine	prasAra_yanwra/viswAra_sAXana#prasAra_yanwra/viswAra_sAXana#noun#2#RM
expression_engine	aBivyakwi_sAXana/prakatana_yukwi(upAya)#aBivyakwi_sAXana/prakatana_yukwi(upAya)#noun#2#RM
freight_engine	mAlavAhaka_vAhana_kA_iMjana#mAlavAhaka_vAhana_kA_iMjana#noun#2#RM
fuel_engine	IMXana_iMjana(yanwra)#IMXana_iMjana(yanwra)#noun#2#RM
gauge_engine	pramApaka_yanwra(maSIna)#pramApaka_yanwra(maSIna)#noun#2#RM
growth_engine	vqxXi(vikAsa)_sAXana#vqxXi(vikAsa)_sAXana#noun#2#RM
haulage_engine	DulAI_maSIna(sAXana)/vahana_Sulka_yanwra#DulAI_maSIna(sAXana)/vahana_Sulka_yanwra#noun#2#RM
inference_engine	anumAna_yukwi/niRkarRa_sAXana#anumAna_yukwi/niRkarRa_sAXana#noun#2#RM
judgement_engine	nirNaya_yukwi/nirXAraNa_yanwra(sAXana)#nirNaya_yukwi/nirXAraNa_yanwra(sAXana)#noun#2#RM
aircraft_engine	vAyuyAna_iMjana#vAyuyAna_iMjana#noun#2#RM
diesel_engine	dIjZala_iMjana#dIjZala_iMjana#noun#2#RM
difference_engine	aMwara_yukwi#aMwara_yukwi#noun#2#RM
fire_engine	xamakala(agni_SAmaka)_iMjana#xamakala(agni_SAmaka)_iMjana#noun#2#RM
gas_engine	gEsa_iMjana#gEsa_iMjana#noun#2#RM
heat_engine	wApa_iMjana#wApa_iMjana#noun#2#RM
ion_engine	Ayana(aNu)_(hewu_prayukwa)_iMjana#Ayana(aNu)_(hewu_prayukwa)_iMjana#noun#2#RM
jet_engine	jeta_iMjana#jeta_iMjana#noun#2#RM
locomotive_engine	rela_iMjana#rela_iMjana#noun#2#RM
rocket_engine	rAketa_iMjana#rAketa_iMjana#noun#2#RM
search_engine	Koja_iMjana#Koja_iMjana#noun#2#RM
steam_engine	BApa_se_calane_vAlA_iMjana#BApa_se_calane_vAlA_iMjana#noun#2#RM
tank_engine	tEMka_iMjana#tEMka_iMjana#noun#2#RM
traction_engine	KIMcane_(kI_kriyA)_meM_prayukwa_iMjana#KIMcane_(kI_kriyA)_meM_prayukwa_iMjana#noun#2#RM
turbojet_engine	tarbojeta_iMjana#tarbojeta_iMjana#noun#2#RM
match_engine	samAna_yukwi/upayukwa_sAXana#samAna_yukwi/upayukwa_sAXana#noun#2#RM
missile_engine	prakRepAswra_kA_iMjana/prakRepAswra_maSIna#prakRepAswra_kA_iMjana/prakRepAswra_maSIna#noun#2#RM
motorcycle_engine	motara_sAikila_kA_iMjana#motara_sAikila_kA_iMjana#noun#2#RM
passenger_engine	paWika_preraka/yAwrI_sAXana#paWika_preraka/yAwrI_sAXana#noun#2#RM
payment_engine	BugawAna_yukwi(sAXana)#BugawAna_yukwi(sAXana)#noun#2#RM
performance_engine	niRpAxana_yukwi/upalabXi_sAXana#niRpAxana_yukwi/upalabXi_sAXana#noun#2#RM
petrol_engine	petrola_cAliwa_iMjana(maSIna)#petrola_cAliwa_iMjana(maSIna)#noun#2#RM
piston_engine	pistana_yukwa_iMjana#pistana_yukwa_iMjana#noun#2#RM
portal_engine	portala_sAXana/portala_aBiyaMwraka#portala_sAXana/portala_aBiyaMwraka#noun#2#RM
print_engine	muxraNa(CapAI)_sAXana#muxraNa(CapAI)_sAXana#noun#2#RM
profit_engine	lABa_yukwi/prApwi_sAXana#lABa_yukwi/prApwi_sAXana#noun#2#RM
quote_engine	uxXaraNa_yukwi#uxXaraNa_yukwi#noun#2#RM
race_engine	sparXA_uwwejaka/xOdZa_preraka#sparXA_uwwejaka/xOdZa_preraka#noun#2#RM
railway_engine	relagAdZI_kA_iMjana#relagAdZI_kA_iMjana#noun#2#RM
recon_engine	samAXAna_yukwi/sAmaMjasya_yukwi#samAXAna_yukwi/sAmaMjasya_yukwi#noun#2#RM
road_engine	sadZaka(mArga)_sAXana#sadZaka(mArga)_sAXana#noun#2#RM
scan_engine	jAzca_sAXana#jAzca_sAXana#noun#2#RM
searche_engine	anveRaNa_yukwi/parIkRaNa_sAXana#anveRaNa_yukwi/parIkRaNa_sAXana#noun#2#RM
sense_engine	samaJa_kI_yukwi/viveka_sAXana#samaJa_kI_yukwi/viveka_sAXana#noun#2#RM
series_engine	SqMKalA_sAXana/krama_yukwi#SqMKalA_sAXana/krama_yukwi#noun#2#RM
siege_engine	GerAbaMxI_yukwi/Gerane_kA_sAXana#GerAbaMxI_yukwi/Gerane_kA_sAXana#noun#2#RM
source_engine	srowa_sAXana/mUla_yukwi#srowa_sAXana/mUla_yukwi#noun#2#RM
speed_engine	gawi_uwpreraka#gawi_uwpreraka#noun#2#RM
stroke_engine	prahAra_sAXana/prahAra_yukwi#prahAra_sAXana/prahAra_yukwi#noun#2#RM
test_engine	parIkRaNa_sAXana#parIkRaNa_sAXana#noun#2#RM
thunderstorm_engine	wadZiwa_vqRti_kA_uwwejaka#wadZiwa_vqRti_kA_uwwejaka#noun#2#RM
ton_engine	tana(wOla)_kA_sAXana#tana(wOla)_kA_sAXana#noun#2#RM
train_engine	gAdZI(relagAdZI)_kA_iMjana#gAdZI(relagAdZI)_kA_iMjana#noun#2#RM
vehicle_engine	vAhana_kA_iMjana#vAhana_kA_iMjana#noun#2#RM
accession_paper	aBigamana_pawra/rAjyArohaNa(paxagrahaNa)_pawra#aBigamana_pawra/rAjyArohaNa(paxagrahaNa)_pawra#noun#2#RM
adoption_paper	aBigrahaNa_pawra/xawwaka_grahaNa_xaswAveja#aBigrahaNa_pawra/xawwaka_grahaNa_xaswAveja#noun#2#RM
agenda_paper	kAryasUcI_pawra#kAryasUcI_pawra#noun#2#RM
amendment_paper	saMSoXana_pawra#saMSoXana_pawra#noun#2#RM
analysis_paper	viSleRaNa_pawra#viSleRaNa_pawra#noun#2#RM
answer_paper	uwwara_pawra/javAbI_xaswAveja#uwwara_pawra/javAbI_xaswAveja#noun#2#RM
appeal_paper	nivexana_pawra#nivexana_pawra#noun#2#RM
art_paper	ciwrakArI_pawra/kalA_leKa#ciwrakArI_pawra/kalA_leKa#noun#2#RM
attestation_paper	anupramANana_pawra/sAkRyAMkana_xaswAveja#anupramANana_pawra/sAkRyAMkana_xaswAveja#noun#2#RM
background_paper	AXAra_pawra/pqRTaBUmi_leKa#AXAra_pawra/pqRTaBUmi_leKa#noun#2#RM
backing_paper	samarWana_pawra#samarWana_pawra#noun#2#RM
board_paper	pariRaxa_pawra/maMdala_ke_xaswAveja#pariRaxa_pawra/maMdala_ke_xaswAveja#noun#2#RM
braille_paper	uwkIrNa_leKa_pawra#uwkIrNa_leKa_pawra#noun#2#RM
broadsheet_paper	viswqwa_Palaka_pawra/pracAra_leKa_pawra#viswqwa_Palaka_pawra/pracAra_leKa_pawra#noun#2#RM
business_paper	vyavasAya_xaswAveja/kArobAra_kAgajAwa#vyavasAya_xaswAveja/kArobAra_kAgajAwa#noun#2#RM
carbon_paper	kArbana_kAgaja/prAMgAra_pawra#kArbana_kAgaja/prAMgAra_pawra#noun#2#RM
cartridge_paper	saPexa_motA_kAgajZa#saPexa_motA_kAgajZa#noun#2#RM
case_paper	mukZaxamA_xasawAveja#mukZaxamA_xasawAveja#noun#2#RM
catalog_paper	nAmasUcI_pawra#nAmasUcI_pawra#noun#2#RM
chart_paper	saMciwra_pawra/vivaraNapata_kA_kAgaja#saMciwra_pawra/vivaraNapata_kA_kAgaja#noun#2#RM
choice_paper	pasanxa_kA_kAgaja/pasanxa_kA_leKa#pasanxa_kA_kAgaja/pasanxa_kA_leKa#noun#2#RM
cigarette_paper	sigareta_meM_prayukwa_kAgaja#sigareta_meM_prayukwa_kAgaja#noun#2#RM
command_paper	aXikAra_pawra#aXikAra_pawra#noun#2#RM
committee_paper	samiwi(saBA)_pawra/Ayoga_leKa_pawra#samiwi(saBA)_pawra/Ayoga_leKa_pawra#noun#2#RM
companion_paper	sahayogI_(leKa)_pawra/sAJA_SoXa_pawra#sahayogI_(leKa)_pawra/sAJA_SoXa_pawra#noun#2#RM
consultation_paper	parAmarSa_pawra#parAmarSa_pawra#noun#2#RM
context_paper	sanxarBa_leKa/prakaraNa_pawra#sanxarBa_leKa/prakaraNa_pawra#noun#2#RM
copier_paper	prawilipika_kAgaja#prawilipika_kAgaja#noun#2#RM
copy_paper	prawilipi_kAgaja(pawra)/leKa_pawra#prawilipi_kAgaja(pawra)/leKa_pawra#noun#2#RM
core_paper	mUla_pawra/AXAra(muKya)_pawra#mUla_pawra/AXAra(muKya)_pawra#noun#2#RM
course_paper	pATyakrama_pawra/aXyayana_SoXa_pawra#pATyakrama_pawra/aXyayana_SoXa_pawra#noun#2#RM
court_paper	nyAyAlaya_pawra/axAlawa_xaswAveja#nyAyAlaya_pawra/axAlawa_xaswAveja#noun#2#RM
cream_paper	cikanA_kAgaja#cikanA_kAgaja#noun#2#RM
crepe_paper	krepa_kAgaja#krepa_kAgaja#noun#2#RM
date_paper	wiWi(xinAzka)_pawra/nirXAraNa_leKa_pawra#wiWi(xinAzka)_pawra/nirXAraNa_leKa_pawra#noun#2#RM
disability_paper	vikalAMgawA_pawra/akRamawA_Avexana_pawra#vikalAMgawA_pawra/akRamawA_Avexana_pawra#noun#2#RM
discussion_paper	paricarcA_(leKa)_pawra/bahasa_xaswAveja#paricarcA_(leKa)_pawra/bahasa_xaswAveja#noun#2#RM
download_paper	aXaHBAraNa_pawra/dAunaloda_pepara#aXaHBAraNa_pawra/dAunaloda_pepara#noun#2#RM
dozen_paper	(eka)xarjana_kAgaja/bAraha_pawra#(eka)xarjana_kAgaja/bAraha_pawra#noun#2#RM
drawing_paper	ciwrakArI_kAgaja/AreKa_pawra#ciwrakArI_kAgaja/AreKa_pawra#noun#2#RM
effects_paper	cala_sampawwi_xaswAveja#cala_sampawwi_xaswAveja#noun#2#RM
end_paper	pariNAma_pawra/samApwi_pawra/anwima_leKa#pariNAma_pawra/samApwi_pawra/anwima_leKa#noun#2#RM
enlistment_paper	BarwI_pawra#BarwI_pawra#noun#2#RM
entrance_paper	praveSa_pawra#praveSa_pawra#noun#2#RM
estate_paper	BU_saMpawwi_xaswAveja#BU_saMpawwi_xaswAveja#noun#2#RM
evening_paper	saMXyAkAlIna_(samAcAra)_pawra#saMXyAkAlIna_(samAcAra)_pawra#noun#2#RM
exam_paper	parIkRA_pawra#parIkRA_pawra#noun#2#RM
family_paper	pArivArika_xaswAveja#pArivArika_xaswAveja#noun#2#RM
filter_paper	Piltara_pepara/niRyaMwaka(CalanI)_kAgaja#Piltara_pepara/niRyaMwaka(CalanI)_kAgaja#noun#2#RM
fine_paper	bahuwa_pawalA_kAgaja#bahuwa_pawalA_kAgaja#noun#2#RM
fourteen_paper	cOxaha_pawra#cOxaha_pawra#noun#2#RM
government_paper	sarakArI_pawra/SAsakIya_xaswAveja#sarakArI_pawra/SAsakIya_xaswAveja#noun#2#RM
grade_paper	SreNI_pawra/vargIkaraNa_pawra#SreNI_pawra/vargIkaraNa_pawra#noun#2#RM
grit_paper	kurakurA(rewa_kaNoM_yukwa)_kAgaja#kurakurA(rewa_kaNoM_yukwa)_kAgaja#noun#2#RM
hemp_paper	BAzga(sana)_ke_pOXe_se_banA_kAgaja#BAzga(sana)_ke_pOXe_se_banA_kAgaja#noun#2#RM
hour_paper	samaya_pawra#samaya_pawra#noun#2#RM
information_paper	sUcanA_pawra#sUcanA_pawra#noun#2#RM
journal_paper	pawrikA_leKa_(pawra)#pawrikA_leKa_(pawra)#noun#2#RM
keynote_paper	mUla_sixXAnwa_pawra/muKya_vicAra_yukwa_leKa#mUla_sixXAnwa_pawra/muKya_vicAra_yukwa_leKa#noun#2#RM
kitchen_paper	pAkaSAlA_meM_prayukwa_kAgaja#pAkaSAlA_meM_prayukwa_kAgaja#noun#2#RM
landmark_paper	sWAna_viSeRa_ko_xarSAne_vAlA_xaswAveja(pawra)#sWAna_viSeRa_ko_xarSAne_vAlA_xaswAveja(pawra)#noun#2#RM
language_paper	BARA(viSeRa)_pawra#BARA(viSeRa)_pawra#noun#2#RM
layout_paper	aBinyAsa_pawra/nakSA_xaswAveja#aBinyAsa_pawra/nakSA_xaswAveja#noun#2#RM
lining_paper	aswara_hewu_prayukwa_kAgaja/parawa_hewu_prayukwa_kAgaja#aswara_hewu_prayukwa_kAgaja/parawa_hewu_prayukwa_kAgaja#noun#2#RM
literature_paper	sAhiwya(viRaya_kA)_pawra#sAhiwya(viRaya_kA)_pawra#noun#2#RM
manuscript_paper	haswalipi_pawra/hAWa_xvArA_liKiwa_pawra#haswalipi_pawra/hAWa_xvArA_liKiwa_pawra#noun#2#RM
meeting_paper	saBA_pawra#saBA_pawra#noun#2#RM
minute_paper	mItiMga(saBA)_kA_vivaraNa_pawra#mItiMga(saBA)_kA_vivaraNa_pawra#noun#2#RM
music_paper	saMgIwa(viRaya_kA)_pawra#saMgIwa(viRaya_kA)_pawra#noun#2#RM
news_paper	samAcAra_pawra#samAcAra_pawra#noun#2#RM
office_paper	kAryAlaya_xaswAveja#kAryAlaya_xaswAveja#noun#2#RM
opening_paper	prAramBika_leKa_pawra/muKya_SoXa_pawra#prAramBika_leKa_pawra/muKya_SoXa_pawra#noun#2#RM
option_paper	vikalpa_pawra#vikalpa_pawra#noun#2#RM
order_paper	AxeSa(AjFA)_pawra#AxeSa(AjFA)_pawra#noun#2#RM
outline_paper	rUpareKA_pawra/sArAMSa_pawra#rUpareKA_pawra/sArAMSa_pawra#noun#2#RM
overview_paper	saMkRipwa_vivaraNa_pawra/samIkRA_pawra#saMkRipwa_vivaraNa_pawra/samIkRA_pawra#noun#2#RM
parchment_paper	carma_pawra/camadZe_ke_(samAna)_kAgajZa#carma_pawra/camadZe_ke_(samAna)_kAgajZa#noun#2#RM
part_paper	AMSika_pawra#AMSika_pawra#noun#2#RM
photo_paper	Poto(ciwra)_hewu_prayukwa_kAgaja#Poto(ciwra)_hewu_prayukwa_kAgaja#noun#2#RM
policy_paper	nIwi_pawra/nIwi_nirXAraNa_xaswAveja#nIwi_pawra/nIwi_nirXAraNa_xaswAveja#noun#2#RM
position_paper	SreNI(sWiwi)_pawra/prawiRTA_pawra#SreNI(sWiwi)_pawra/prawiRTA_pawra#noun#2#RM
poster_paper	vijFApana_hewu_prayukwa_kAgaja/vijFApana_pawra#vijFApana_hewu_prayukwa_kAgaja/vijFApana_pawra#noun#2#RM
publishing_paper	prakASana_pawra#prakASana_pawra#noun#2#RM
account_safety	leKA_surakRA#leKA_surakRA#noun#2#RM
adolescent_safety	kiSora_(kAlIna)_surakRA#kiSora_(kAlIna)_surakRA#noun#2#RM
air_safety	vAyumaNdala_bacAva(surakRA)/havAI_yAwrA_surakRA#vAyumaNdala_bacAva(surakRA)/havAI_yAwrA_surakRA#noun#2#RM
aviation_safety	vimAnana_surakRA#vimAnana_surakRA#noun#2#RM
card_safety	kArda_surakRA/pawraka_bacAva#kArda_surakRA/pawraka_bacAva#noun#2#RM
carrier_safety	saMvAhaka_surakRA#saMvAhaka_surakRA#noun#2#RM
car_safety	kAra(motaragAdZI)_surakRA#kAra(motaragAdZI)_surakRA#noun#2#RM
child_safety	SiSu_surakRA#SiSu_surakRA#noun#2#RM
computer_safety	kampyUtara(aBikaliwra)_surakRA#kampyUtara(aBikaliwra)_surakRA#noun#2#RM
consumer_safety	upaBokwA_surakRA#upaBokwA_surakRA#noun#2#RM
crash_safety	xurGatanA_bacAva#xurGatanA_bacAva#noun#2#RM
customer_safety	grAhaka_surakRA#grAhaka_surakRA#noun#2#RM
cycle_safety	sAikila_surakRA#sAikila_surakRA#noun#2#RM
cyclist_safety	sAikila_cAlaka_surakRA#sAikila_cAlaka_surakRA#noun#2#RM
employee_safety	karmacArI_surakRA#karmacArI_surakRA#noun#2#RM
fire_safety	agni_bacAva(surakRA)#agni_bacAva(surakRA)#noun#2#RM
flight_safety	udZAna_surakRA#udZAna_surakRA#noun#2#RM
food_safety	Bojana_bacAva/AhAra_surakRA#Bojana_bacAva/AhAra_surakRA#noun#2#RM
data_application	AzkadZA_anuprayoga#AzkadZA_anuprayoga#noun#2#RM
database_application	AMkadZAsaMcaya_anuprayoga#AMkadZAsaMcaya_anuprayoga#noun#2#RM
datum_application	waWya_anuprayoga(AXAra_AzkadZA_anuprayoga)#waWya_anuprayoga(AXAra_AzkadZA_anuprayoga)#noun#2#RM
day_application	niSciwa_xivasAnuprayoga#niSciwa_xivasAnuprayoga#noun#2#RM
default_application	asaPala_anuprayoga(xoRapUrNa_anuprayoga)#asaPala_anuprayoga(xoRapUrNa_anuprayoga)#noun#2#RM
defence_application	surakRA_nivexana(rakRA_anuprayoga)#surakRA_nivexana(rakRA_anuprayoga)#noun#2#RM
degree_application	upAXi_Avexana#upAXi_Avexana#noun#2#RM
demo_application	praxarSana_nivexana#praxarSana_nivexana#noun#2#RM
demolition_application	girAne_hewu_Avexana(wodZa_PodZa_hewu_Avexana)#girAne_hewu_Avexana(wodZa_PodZa_hewu_Avexana)#noun#2#RM
demonstration_application	nixarSana_anuprayoga(praxarSana_Avexana)#nixarSana_anuprayoga(praxarSana_Avexana)#noun#2#RM
design_application	prArUpa_saMprayoga#prArUpa_saMprayoga#noun#2#RM
desktop_application	deskatoYpa_anuprayoga#deskatoYpa_anuprayoga#noun#2#RM
destination_application	lakRya_saMprayoga#lakRya_saMprayoga#noun#2#RM
device_application	upakaraNa_anuprayoga#upakaraNa_anuprayoga#noun#2#RM
disclosure_application	prakatana_nivexana#prakatana_nivexana#noun#2#RM
display_application	praxarSana_nivexana#praxarSana_nivexana#noun#2#RM
download_application	dAunaloda_Avexana(aXoBAraNa_anuprayoga)#dAunaloda_Avexana(aXoBAraNa_anuprayoga)#noun#2#RM
draft_application	prArUpa_Avexana#prArUpa_Avexana#noun#2#RM
drawing_application	AreKa_anuprayoga#AreKa_anuprayoga#noun#2#RM
drilling_application	beXana_anuprayoga(KuxAI_hewu_Avexana)#beXana_anuprayoga(KuxAI_hewu_Avexana)#noun#2#RM
duty_application	Sulka_Avexana#Sulka_Avexana#noun#2#RM
ecommerce_application	I_vyApAra_Avexana(vixyuwIya_vANijya_Avexana)#I_vyApAra_Avexana(vixyuwIya_vANijya_Avexana)#noun#2#RM
edge_application	wIkRNa(wIvra)_anuprayoga#wIkRNa(wIvra)_anuprayoga#noun#2#RM
electronics_application	ilektroYnikI_anuprayoga#ilektroYnikI_anuprayoga#noun#2#RM
email_application	Imela_Avexana(vixyuwa_pawra_Avexana)#Imela_Avexana(vixyuwa_pawra_Avexana)#noun#2#RM
ergency_application	ApAwakAlIna_anuprayoga(ApAwakAlika_Avexana)#ApAwakAlIna_anuprayoga(ApAwakAlika_Avexana)#noun#2#RM
end_application	uxXeSya_anuprayoga(samApwi_Avexana)#uxXeSya_anuprayoga(samApwi_Avexana)#noun#2#RM
energy_application	UrjA_saMprayoga#UrjA_saMprayoga#noun#2#RM
engineering_application	aBiyAMwrikI_anuprayoga#aBiyAMwrikI_anuprayoga#noun#2#RM
enterprise_application	vyApArika_anuprayoga#vyApArika_anuprayoga#noun#2#RM
entertainment_application	manoraMjana_nivexana(sawkAra_saMprayoga)#manoraMjana_nivexana(sawkAra_saMprayoga)#noun#2#RM
example_application	AxarSa_samprayoga(uxAharaNa_anuprayoga)#AxarSa_samprayoga(uxAharaNa_anuprayoga)#noun#2#RM
extranet_application	awirikwa_netavarka(intaraneta)_anuprayoga#awirikwa_netavarka(intaraneta)_anuprayoga#noun#2#RM
faculty_application	kRamawA_anuprayoga(saMkAya_Avexana)#kRamawA_anuprayoga(saMkAya_Avexana)#noun#2#RM
fertiliser_application	urvaraka_anuprayoga(KAxa_saMprayoga)#urvaraka_anuprayoga(KAxa_saMprayoga)#noun#2#RM
field_application	kRewrIya_anuprayoga(kRewra_hewu_Avexana)#kRewrIya_anuprayoga(kRewra_hewu_Avexana)#noun#2#RM
firm_application	suxqDa_anuprayoga(vyavasAya_saMGa_hewu_Avexana)#suxqDa_anuprayoga(vyavasAya_saMGa_hewu_Avexana)#noun#2#RM
following_application	AgAmI_anuprayoga#AgAmI_anuprayoga#noun#2#RM
food_application	KAxya_(hewu)_Avexana(AhAra_anuprayoga)#KAxya_(hewu)_Avexana(AhAra_anuprayoga)#noun#2#RM
footpath_application	pagadaMdI_nivexana(pagadaMdI_saMprayoga)#pagadaMdI_nivexana(pagadaMdI_saMprayoga)#noun#2#RM
force_application	xabAva_anuprayoga(gawi_saMprayoga)#xabAva_anuprayoga(gawi_saMprayoga)#noun#2#RM
form_application	aBirUpa_anuprayoga#aBirUpa_anuprayoga#noun#2#RM
framework_application	rUpareKA_Avexana(saMracanA_sambanXa)#rUpareKA_Avexana(saMracanA_sambanXa)#noun#2#RM
frequency_application	Avqwwi_anuprayoga#Avqwwi_anuprayoga#noun#2#RM
funding_application	niXIyana_Avexana#niXIyana_Avexana#noun#2#RM
fungicide_application	PaPUzxanASI_anuprayoga#PaPUzxanASI_anuprayoga#noun#2#RM
gaming_application	juA_Avexana(xyUwa_saMprayoga)#juA_Avexana(xyUwa_saMprayoga)#noun#2#RM
grant_application	anuxAna_Avexana#anuxAna_Avexana#noun#2#RM
ground_application	mUla_anuprayoga(pqRTaBUmIya_saMprayoga)#mUla_anuprayoga(pqRTaBUmIya_saMprayoga)#noun#2#RM
healthcare_application	svAsWya_sevA_hewu_Avexana#svAsWya_sevA_hewu_Avexana#noun#2#RM
helper_application	sahAyaka_(paxa_hewu)Avexana_pawra#sahAyaka_(paxa_hewu)Avexana_pawra#noun#2#RM
herbicide_application	wqNa_nASaka_anuprayoga#wqNa_nASaka_anuprayoga#noun#2#RM
homebrew_application	Gara_meM_banAyI_huI_SarAba_kA_saMprayoga#Gara_meM_banAyI_huI_SarAba_kA_saMprayoga#noun#2#RM
homelessness_application	AvAsahInawA_Avexana#AvAsahInawA_Avexana#noun#2#RM
host_application	mejabAna_nivexana(Ayojaka_Avexana)#mejabAna_nivexana(Ayojaka_Avexana)#noun#2#RM
hour_application	sAmayika_saMprayoga#sAmayika_saMprayoga#noun#2#RM
housing_application	AvAsa_hewu_Avexana#AvAsa_hewu_Avexana#noun#2#RM
htm_application	hAipara_teksta_mArkaapa_anuprayoga#hAipara_teksta_mArkaapa_anuprayoga#noun#2#RM
hypermedia_application	hAipara_teksta_viswAra_anuprayoga#hAipara_teksta_viswAra_anuprayoga#noun#2#RM
ict_application	sUcanA_saMcAra_saMprayoga#sUcanA_saMcAra_saMprayoga#noun#2#RM
imaging_application	prawIka_anuprayoga#prawIka_anuprayoga#noun#2#RM
information_application	sUcanA_Avexana#sUcanA_Avexana#noun#2#RM
injunction_application	AjFA_pawra_nivexana#AjFA_pawra_nivexana#noun#2#RM
nternet_application	iMtaraneta_(hewu)Avexana(iMtaraneta_ke_anuprayoga)#iMtaraneta_(hewu)Avexana(iMtaraneta_ke_anuprayoga)#noun#2#RM
intranet_application	AwaMrika_viswAra(anwaH_jAla)_Avexana#AwaMrika_viswAra(anwaH_jAla)_Avexana#noun#2#RM
itunes_application	AI_tyUnsa_anuprayoga(eka_viSeRa_prakAra_kA_manoraMjana_viswAra_anuprayoga)#AI_tyUnsa_anuprayoga(eka_viSeRa_prakAra_kA_manoraMjana_viswAra_anuprayoga)#noun#2#RM
journal_application	pawrikA_nivexana#pawrikA_nivexana#noun#2#RM
kde_application	linaksa_para_kArya_karane_hewu_eka_viSeRa_anuprayoga#linaksa_para_kArya_karane_hewu_eka_viSeRa_anuprayoga#noun#2#RM
killer_application	hawyAre_kA_nivexana#hawyAre_kA_nivexana#noun#2#RM
knowledge_application	jFAna_saMprayoga(boXAnuprayoga)#jFAna_saMprayoga(boXAnuprayoga)#noun#2#RM
legacy_application	pEwqka_saMpawwi_nivexana#pEwqka_saMpawwi_nivexana#noun#2#RM
leisure_application	avakASa_Avexana(viSrAma_hewu_Avexana)#avakASa_Avexana(viSrAma_hewu_Avexana)#noun#2#RM
library_application	puswakAlaya_Avexana#puswakAlaya_Avexana#noun#2#RM
licence_application	aXikAra_pawra_Avexana#aXikAra_pawra_Avexana#noun#2#RM
license_application	anujFA_pawra_Avexana#anujFA_pawra_Avexana#noun#2#RM
licensing_application	anujFA_praxAwA_Avexana#anujFA_praxAwA_Avexana#noun#2#RM
life_application	jIvana_(xAna_hewu)_nivexana(jIvana_ke_anuprayoga)#jIvana_(xAna_hewu)_nivexana(jIvana_ke_anuprayoga)#noun#2#RM
line_application	SraMKalA(SqMKalA)_Avexana(krama_nivexana)#SraMKalA(SqMKalA)_Avexana(krama_nivexana)#noun#2#RM
mail_application	dAka_Avexana#dAka_Avexana#noun#2#RM
maintenance_application	anurakRaNa_Avexana#anurakRaNa_Avexana#noun#2#RM
management_application	prabanXana_Avexana#prabanXana_Avexana#noun#2#RM
manufacturing_application	uwpAxana_(hewu)_Avexana#uwpAxana_(hewu)_Avexana#noun#2#RM
map_application	mAnaciwra_Avexana#mAnaciwra_Avexana#noun#2#RM
matter_application	viRayavaswu_nivexana(paxArWAnuprayoga)#viRayavaswu_nivexana(paxArWAnuprayoga)#noun#2#RM
medium_application	sAXana_saMprayoga(maXyama_anuprayoga)#sAXana_saMprayoga(maXyama_anuprayoga)#noun#2#RM
membership_application	saxasyawA_Avexana#saxasyawA_Avexana#noun#2#RM
messenger_application	sanxeSa_vAhaka_nivexana#sanxeSa_vAhaka_nivexana#noun#2#RM
microwave_application	sUkRma_waraMgIya_anuprayoga#sUkRma_waraMgIya_anuprayoga#noun#2#RM
model_application	AxarSa_saMprayoga#AxarSa_saMprayoga#noun#2#RM
monitoring_application	anuSravaNa_anuprayoga#anuSravaNa_anuprayoga#noun#2#RM
multimedia_application	bahu_mAXyamIya_saMprayoga#bahu_mAXyamIya_saMprayoga#noun#2#RM
nanotechnology_application	awisUkRma_proxyOgikI_anuprayoga#awisUkRma_proxyOgikI_anuprayoga#noun#2#RM
naturalisation_application	sahajIkaraNa_anuprayoga(prakqwikaraNa_saMprayoga)#sahajIkaraNa_anuprayoga(prakqwikaraNa_saMprayoga)#noun#2#RM
need_application	AvaSyakawA_hewu_Avexana#AvaSyakawA_hewu_Avexana#noun#2#RM
notice_application	sUcanA_nivexana#sUcanA_nivexana#noun#2#RM
novel_application	navIna_saMprayoga#navIna_saMprayoga#noun#2#RM
office_application	kAryAlaya_hewu_Avexana(viBAgIya_nivexana)#kAryAlaya_hewu_Avexana(viBAgIya_nivexana)#noun#2#RM
outline_application	rUpareKAnuprayoga#rUpareKAnuprayoga#noun#2#RM
packaging_application	saMveRtana_anuprayoga#saMveRtana_anuprayoga#noun#2#RM
page_application	pqRTAMkiwa_anuprayoga(nivexana)#pqRTAMkiwa_anuprayoga(nivexana)#noun#2#RM
paper_application	liKiwa_nivexana(xaswAveja_hewu_Avexana)#liKiwa_nivexana(xaswAveja_hewu_Avexana)#noun#2#RM
parte_application	eka_pakRIya_anuprayoga(ekAMgI_anuprayoga)#eka_pakRIya_anuprayoga(ekAMgI_anuprayoga)#noun#2#RM
partner_application	BAgIxAra_(kA/ke_liye)nivexana#BAgIxAra_(kA/ke_liye)nivexana#noun#2#RM
party_application	xala_(saMracanA_hewu)Avexana/(xalagawa_anuprayoga)#xala_(saMracanA_hewu)Avexana/(xalagawa_anuprayoga)#noun#2#RM
patent_application	ekasva_aXikAra_Avexana#ekasva_aXikAra_Avexana#noun#2#RM
pct_application	anwarrARtrIya_ekasva_aXikAra_niyama_hewu_Avexana(peteMta_kopareSana_trItI_nivexana)#anwarrARtrIya_ekasva_aXikAra_niyama_hewu_Avexana(peteMta_kopareSana_trItI_nivexana)#noun#2#RM
pdf_application	svawanwra_xaswAveja_prArUpa_anuprayoga(portebala_dokyUmeMta_PoYrmeta)#svawanwra_xaswAveja_prArUpa_anuprayoga(portebala_dokyUmeMta_PoYrmeta)#noun#2#RM
performance_application	kArya_niRpAxana_nivexana(kRamawA_saMprayoga)#kArya_niRpAxana_nivexana(kRamawA_saMprayoga)#noun#2#RM
permission_application	anumawi_nivexana#anumawi_nivexana#noun#2#RM
permit_application	anujFApawra_Avexana#anujFApawra_Avexana#noun#2#RM
pesticide_application	kItanASaka_anuprayoga#kItanASaka_anuprayoga#noun#2#RM
pharmacy_application	ORaXaSAlA_nirmANa_hewu_Avexana(ORaXa_vijFAna_anuprayoga)#ORaXaSAlA_nirmANa_hewu_Avexana(ORaXa_vijFAna_anuprayoga)#noun#2#RM
plan_application	yojanA_Avexana#yojanA_Avexana#noun#2#RM
planning_application	saMyojanA_saMprayoga#saMyojanA_saMprayoga#noun#2#RM
postgraduate_application	aXisnAwaka_(hewu)_Avexana#aXisnAwaka_(hewu)_Avexana#noun#2#RM
power_application	bijalI_vyavasWA_hewu_Avexana#bijalI_vyavasWA_hewu_Avexana#noun#2#RM
preference_application	pasaMxagI_hewu(cunAva/prAWamikawA)_nivexana#pasaMxagI_hewu(cunAva/prAWamikawA)_nivexana#noun#2#RM
pressure_application	xabAva_hewu_anuprayoga#xabAva_hewu_anuprayoga#noun#2#RM
prioritise_application	prAWamikawA_hewu_nivexana#prAWamikawA_hewu_nivexana#noun#2#RM
process_application	prakriyA_anuprayoga#prakriyA_anuprayoga#noun#2#RM
processing_application	prakramaNa(prakriyAwmaka)_saMprayoga#prakramaNa(prakriyAwmaka)_saMprayoga#noun#2#RM
production_application	uwpAxana_Avexana#uwpAxana_Avexana#noun#2#RM
productivity_application	uwpAxakawA_anuprayoga#uwpAxakawA_anuprayoga#noun#2#RM
project_application	pariyojanA_Avexana#pariyojanA_Avexana#noun#2#RM
prototype_application	prArUpa_Avexana#prArUpa_Avexana#noun#2#RM
pupillage_application	SikRArWI_Avexana(SiRyawA_saMprayoga)#SikRArWI_Avexana(SiRyawA_saMprayoga)#noun#2#RM
purpose_application	lakRyAnuprayoga#lakRyAnuprayoga#noun#2#RM
quality_application	guNavawwAnuprayoga#guNavawwAnuprayoga#noun#2#RM
range_application	viswAra_anuprayoga#viswAra_anuprayoga#noun#2#RM
reality_application	yaWArWa_saMprayoga#yaWArWa_saMprayoga#noun#2#RM
recording_application	XvanyAleKana_anuprayoga#XvanyAleKana_anuprayoga#noun#2#RM
refurbishment_application	jIrNoxXAra_nivexana(punarnavInIkaraNa_hewu_Avexana)#jIrNoxXAra_nivexana(punarnavInIkaraNa_hewu_Avexana)#noun#2#RM
regulation_application	vyavasWApana_nivexana#vyavasWApana_nivexana#noun#2#RM
reinforcement_application	suxqDZIkaraNa_anuprayoga#suxqDZIkaraNa_anuprayoga#noun#2#RM
relief_application	sahAyawA_nivexana(rAhawa_Avexana)#sahAyawA_nivexana(rAhawa_Avexana)#noun#2#RM
renewal_application	navInIkaraNa(punarAraMBa)_Avexana#navInIkaraNa(punarAraMBa)_Avexana#noun#2#RM
repeat_application	punarAvqwwi_nivexana#punarAvqwwi_nivexana#noun#2#RM
research_application	SoXa_Avexana(anveRaNa_anuprayoga)#SoXa_Avexana(anveRaNa_anuprayoga)#noun#2#RM
return_application	prawigama_Avexana(prawyuwwara_nivexana)#prawigama_Avexana(prawyuwwara_nivexana)#noun#2#RM
review_application	punarIkRaNa_Avexana#punarIkRaNa_Avexana#noun#2#RM
safety_application	surakRA_nivexana#surakRA_nivexana#noun#2#RM
sale_application	bikrI_Avexana(vikraya_hewu_Avexana)#bikrI_Avexana(vikraya_hewu_Avexana)#noun#2#RM
sample_application	namUnA_Avexana(AxarSa_anuprayoga)#namUnA_Avexana(AxarSa_anuprayoga)#noun#2#RM
scholarship_application	CAwravqwwi_Avexana#CAwravqwwi_Avexana#noun#2#RM
school_application	vixyAlaya_Avexana(sampraxAya_saMprayoga)#vixyAlaya_Avexana(sampraxAya_saMprayoga)#noun#2#RM
sector_application	kRewra_viSeRa_hewu_nivexana(kAryakRewra_Avexana)#kRewra_viSeRa_hewu_nivexana(kAryakRewra_Avexana)#noun#2#RM
security_application	bacAva_nivexana(prawiBUwi_Avexana)#bacAva_nivexana(prawiBUwi_Avexana)#noun#2#RM
sensor_application	saMvexaka_anuprayoga#saMvexaka_anuprayoga#noun#2#RM
server_application	sevaka/sevikA_Avexana(muKya_saMgaNaka_anuprayoga)#sevaka/sevikA_Avexana(muKya_saMgaNaka_anuprayoga)#noun#2#RM
service_application	sevA_nivexana(nOkarI_hewu_Avexana)#sevA_nivexana(nOkarI_hewu_Avexana)#noun#2#RM
share_application	prawiBUwi_Avexana(hisse_hewu_Avexana)#prawiBUwi_Avexana(hisse_hewu_Avexana)#noun#2#RM
simulation_application	anukqwi_nivexana#anukqwi_nivexana#noun#2#RM
skill_application	kuSala_anuprayoga(pravINawA_hewu_Avexana)#kuSala_anuprayoga(pravINawA_hewu_Avexana)#noun#2#RM
software_application	sAPtaveyara(kamputara_xvArA_prayukwa_kArya_sampAxana)_anuprayoga#sAPtaveyara(kamputara_xvArA_prayukwa_kArya_sampAxana)_anuprayoga#noun#2#RM
source_application	srowa_saMprayoga#srowa_saMprayoga#noun#2#RM
space_application	aMwarikRa_anuprayoga#aMwarikRa_anuprayoga#noun#2#RM
specialist_application	guNavawwA_anuprayoga(viSeRajFa_hewu_nivexana)#guNavawwA_anuprayoga(viSeRajFa_hewu_nivexana)#noun#2#RM
speech_application	BARA_anuprayoga(vANI_saMprayoga)#BARA_anuprayoga(vANI_saMprayoga)#noun#2#RM
speed_application	gawi_saMprayoga#gawi_saMprayoga#noun#2#RM
spreadsheet_application	viswqwa_pawra_para_anuprayoga(viswqwa_pawra_hewu_nivexana)#viswqwa_pawra_para_anuprayoga(viswqwa_pawra_hewu_nivexana)#noun#2#RM
statement_application	vivaraNa_nivexana(vakwavya_prAyojyawA)#vivaraNa_nivexana(vakwavya_prAyojyawA)#noun#2#RM
store_application	BaNdAra_hewu_Avexana(saMciwa_vaswu_saMprayoga)#BaNdAra_hewu_Avexana(saMciwa_vaswu_saMprayoga)#noun#2#RM
student_application	vixyArWI_Avexana#vixyArWI_Avexana#noun#2#RM
studio_application	stUdiyo(prasAra_kakRa)_hewu_nivexana#stUdiyo(prasAra_kakRa)_hewu_nivexana#noun#2#RM
subscription_application	Sulka(aBixAna)_Avexana#Sulka(aBixAna)_Avexana#noun#2#RM
suit_application	aBiyoga_Avexana#aBiyoga_Avexana#noun#2#RM
summary_application	sArAMSa_nivexana#sArAMSa_nivexana#noun#2#RM
summer_application	grIRmAnuprayoga#grIRmAnuprayoga#noun#2#RM
surveillance_application	AvekRaNa_Avexana#AvekRaNa_Avexana#noun#2#RM
switch_application	parivarwana_hewu_anuprayoga(svica_hewu_Avexana)#parivarwana_hewu_anuprayoga(svica_hewu_Avexana)#noun#2#RM
system_application	sixXAnwa_samprayoga(vyavasWA_nivexana)#sixXAnwa_samprayoga(vyavasWA_nivexana)#noun#2#RM
target_application	lakRyAnuprayoga#lakRyAnuprayoga#noun#2#RM
teaching_application	aXyApana_Avexana(SikRaNa_samprayoga)#aXyApana_Avexana(SikRaNa_samprayoga)#noun#2#RM
technology_application	wakanIkI_anuprayoga#wakanIkI_anuprayoga#noun#2#RM
telecommunication_application	xUrasaMcAra_suviXA_hewu_Avexana(xUrasaMcAra_kA_anuprayoga)#xUrasaMcAra_suviXA_hewu_Avexana(xUrasaMcAra_kA_anuprayoga)#noun#2#RM
telephone_application	xUraBARa_hewu_Avexana#xUraBARa_hewu_Avexana#noun#2#RM
telephony_application	xUraBARI_anuprayoga#xUraBARI_anuprayoga#noun#2#RM
temperature_application	wApakrama(wApamAna)_anuprayoga#wApakrama(wApamAna)_anuprayoga#noun#2#RM
term_application	sawra_Avexana(niSciwa_avaXIya_anuprayoga)#sawra_Avexana(niSciwa_avaXIya_anuprayoga)#noun#2#RM
test_application	parIkRA_Avexana#parIkRA_Avexana#noun#2#RM
text_application	pATya_BAga_hewu_nivexana#pATya_BAga_hewu_nivexana#noun#2#RM
ticket_application	tikata_Avexana#tikata_Avexana#noun#2#RM
time_application	sAmayika_anuprayoga(samaya_hewu_nivexana)#sAmayika_anuprayoga(samaya_hewu_nivexana)#noun#2#RM
training_application	praSikRaNa_Avexana#praSikRaNa_Avexana#noun#2#RM
transfer_application	sWAnAnwaraNa_Avexana#sWAnAnwaraNa_Avexana#noun#2#RM
transport_application	parivahana(yAwAyAwa)_Avexana#parivahana(yAwAyAwa)_Avexana#noun#2#RM
transportation_application	parivahana_vyavasWA_nivexana#parivahana_vyavasWA_nivexana#noun#2#RM
tribunal_application	nyAyAXikaraNa_Avexana#nyAyAXikaraNa_Avexana#noun#2#RM
university_application	viSvavixyAlaya_Avexana#viSvavixyAlaya_Avexana#noun#2#RM
use_application	upayoga_hewu_Avexana(upaBoga_samprayoga)#upayoga_hewu_Avexana(upaBoga_samprayoga)#noun#2#RM
user_application	upayokwA_Avexana#upayokwA_Avexana#noun#2#RM
value_application	mUlya_Avexana(guNavawwA_anuprayoga)#mUlya_Avexana(guNavawwA_anuprayoga)#noun#2#RM
vehicle_application	vAhana_Avexana#vAhana_Avexana#noun#2#RM
vet_application	paSucikiwsaka_Avexana#paSucikiwsaka_Avexana#noun#2#RM
video_application	vIdiyo(kEmarA)_nivexana#vIdiyo(kEmarA)_nivexana#noun#2#RM
visa_application	vIsA(rARtra_viSeRa_praveSa_hewu_svIkqwi)_Avexana#vIsA(rARtra_viSeRa_praveSa_hewu_svIkqwi)_Avexana#noun#2#RM
voice_application	svara_samprayoga(aBivyakwi_nivexana)#svara_samprayoga(aBivyakwi_nivexana)#noun#2#RM
voltage_application	vixyuwa_saMcAlana_Sakwi_samprayoga#vixyuwa_saMcAlana_Sakwi_samprayoga#noun#2#RM
volume_application	viswAra_anuprayoga#viswAra_anuprayoga#noun#2#RM
vote_application	mawaxAna_Avexana#mawaxAna_Avexana#noun#2#RM
wallet_application	Cote_batue_hewu_nivexana(alpa/sUkRma_anuprayoga)#Cote_batue_hewu_nivexana(alpa/sUkRma_anuprayoga)#noun#2#RM
warrant_application	vAraMta(aXipawra)_Avexana#vAraMta(aXipawra)_Avexana#noun#2#RM
way_application	mArga_Avexana(SElI_anuprayoga)#mArga_Avexana(SElI_anuprayoga)#noun#2#RM
web_application	veba_anuprayoga(veba_pqRTa_banAne_hewu_Avexana)#veba_anuprayoga(veba_pqRTa_banAne_hewu_Avexana)#noun#2#RM
window_application	viMdo_anuprayoga(kampyUtara_kI_viSeRa_kriyApraNAlI_anuprayoga)#viMdo_anuprayoga(kampyUtara_kI_viSeRa_kriyApraNAlI_anuprayoga)#noun#2#RM
wireless_application	bewAra_saMpreRaNa_anuprayoga#bewAra_saMpreRaNa_anuprayoga#noun#2#RM
word_application	SabxAnuprayoga#SabxAnuprayoga#noun#2#RM
world_application	vESvika_anuprayoga(awyaXika_anuprayoga)#vESvika_anuprayoga(awyaXika_anuprayoga)#noun#2#RM
activity_club	gawiviXi_saMsWA(kriyAkalApa_klaba)#gawiviXi_saMsWA(kriyAkalApa_klaba)#noun#2#RM
art_club	kalA_saBA#kalA_saBA#noun#2#RM
athletics_club	KelakUxa_saBA(vyAyAma_klaba)#KelakUxa_saBA(vyAyAma_klaba)#noun#2#RM
badminton_club	bEdamiMtana_klaba#bEdamiMtana_klaba#noun#2#RM
beach_club	samuxra_wata_sWiwa_klaba(bIca_klaba)#samuxra_wata_sWiwa_klaba(bIca_klaba)#noun#2#RM
bingo_club	biMgo_klaba(biMgo=kArda_para_aMkiwa_saMKyA_xvArA_KelejAnA_vAlA_Kela)#biMgo_klaba(biMgo=kArda_para_aMkiwa_saMKyA_xvArA_KelejAnA_vAlA_Kela)#noun#2#RM
blue_club	blU_klaba(brija_nIlAmI_wanwra_saMsWA)#blU_klaba(brija_nIlAmI_wanwra_saMsWA)#noun#2#RM
boat_club	nOkA_klaba#nOkA_klaba#noun#2#RM
book_club	puswaka_klaba#puswaka_klaba#noun#2#RM
bowling_club	geMxabAjI_klaba#geMxabAjI_klaba#noun#2#RM
boxing_club	mukkebAjZI(boYksiMga)_klaba#mukkebAjZI(boYksiMga)_klaba#noun#2#RM
boy_club	ladZakoM_hewu_klaba#ladZakoM_hewu_klaba#noun#2#RM
boyhood_club	ladZakapana_(gawiviXi)_klaba#ladZakapana_(gawiviXi)_klaba#noun#2#RM
breakfast_club	jalapAna_klaba#jalapAna_klaba#noun#2#RM
breed_club	prajanana_klaba(poRaNa_klaba)#prajanana_klaba(poRaNa_klaba)#noun#2#RM
bridge_club	samparka_sambanXa_saBA#samparka_sambanXa_saBA#noun#2#RM
business_club	vyavasAya_klaba(kArobAra_saMsWA)#vyavasAya_klaba(kArobAra_saMsWA)#noun#2#RM
camera_club	kEmarA_klaba#kEmarA_klaba#noun#2#RM
canoe_club	doMgI_klaba(CotI_nOkA_klaba)#doMgI_klaba(CotI_nOkA_klaba)#noun#2#RM
car_club	motaragAdZI_klaba(kAra_klaba)#motaragAdZI_klaba(kAra_klaba)#noun#2#RM
card_club	kArda_klaba#kArda_klaba#noun#2#RM
caving_club	kanxarA(suraMga)_kArya_meM_saMlagna_saMsWA#kanxarA(suraMga)_kArya_meM_saMlagna_saMsWA#noun#2#RM
chess_club	SawaraMja_klaba#SawaraMja_klaba#noun#2#RM
childrens_club	baccoM_hewu_klaba#baccoM_hewu_klaba#noun#2#RM
citizen_club	nAgarika_klaba(pOra_saBA)#nAgarika_klaba(pOra_saBA)#noun#2#RM
class_club	vargIkaraNa_saBA(klaba)/SreNI_saBA#vargIkaraNa_saBA(klaba)/SreNI_saBA#noun#2#RM
comedy_club	hAsya_saBA(komedI_klaba)#hAsya_saBA(komedI_klaba)#noun#2#RM
community_club	sAmuxAyika_saBA(keMxra)#sAmuxAyika_saBA(keMxra)#noun#2#RM
computer_club	kampyUtara_klaba#kampyUtara_klaba#noun#2#RM
country_club	kantrI_klaba(eka_prakAra_kA_klaba)/manoraMjana_saBA#kantrI_klaba(eka_prakAra_kA_klaba)/manoraMjana_saBA#noun#2#RM
craft_club	SilpakalA_saMsWA#SilpakalA_saMsWA#noun#2#RM
cricket_club	kriketa_klaba#kriketa_klaba#noun#2#RM
curling_club	hima_krIdZA_klaba(eka_prakAra_kA_barPa_Kela_kA_klaba)#hima_krIdZA_klaba(eka_prakAra_kA_barPa_Kela_kA_klaba)#noun#2#RM
cycling_club	sAikliMga_klaba(sAikila_calAne_kI_krIdA_saMsWA)#sAikliMga_klaba(sAikila_calAne_kI_krIdA_saMsWA)#noun#2#RM
dance_club	nqwya_saBA(nqwya_kenxra)#nqwya_saBA(nqwya_kenxra)#noun#2#RM
decameron_club	dI-kemeroM_klaba(italI_ke_leKaka_bokAsio_xvArA_liKiwa_kaWA_saMgraha_para_vicAra_vimarSa_hewu_saMsWA)#dI-kemeroM_klaba(italI_ke_leKaka_bokAsio_xvArA_liKiwa_kaWA_saMgraha_para_vicAra_vimarSa_hewu_saMsWA)#noun#2#RM
dive_club	gowAKorI_klaba#gowAKorI_klaba#noun#2#RM
division_club	praBAga_saBA(maMdala_saBA)#praBAga_saBA(maMdala_saBA)#noun#2#RM
drama_club	aBinaya_klaba(nAtya_saBA)#aBinaya_klaba(nAtya_saBA)#noun#2#RM
euro_club	yUro_klaba#yUro_klaba#noun#2#RM
family_club	parivAra_saMGa(pArivArika_saBA)#parivAra_saMGa(pArivArika_saBA)#noun#2#RM
fan_club	praSaMsaka_saMGa#praSaMsaka_saMGa#noun#2#RM
feeder_club	sahAyaka_saMsWA(poRaka_samUha)#sahAyaka_saMsWA(poRaka_samUha)#noun#2#RM
fishing_club	maCalI_pakadZane_kI_kriyA_se_sambaxXa_saMsWA(PiSiMga_klaba)#maCalI_pakadZane_kI_kriyA_se_sambaxXa_saMsWA(PiSiMga_klaba)#noun#2#RM
flight_club	vimAna_yAwAyAwa_saMGa/udZAna_klaba#vimAna_yAwAyAwa_saMGa/udZAna_klaba#noun#2#RM
folk_club	loka_saMskqwi_saBA#loka_saMskqwi_saBA#noun#2#RM
football_club	PutaboYla_saMGa(klaba)#PutaboYla_saMGa(klaba)#noun#2#RM
game_club	Kela_klaba(saMGa)/krIdZA_kenxra#Kela_klaba(saMGa)/krIdZA_kenxra#noun#2#RM
gardening_club	bAgabAnI_saBA(saMGa)#bAgabAnI_saBA(saMGa)#noun#2#RM
golf_club	golPa_klaba#golPa_klaba#noun#2#RM
gun_club	banxUka_gqha/gana_klaba#banxUka_gqha/gana_klaba#noun#2#RM
gym_club	vyAyAma_SAlA/jima_klaba#vyAyAma_SAlA/jima_klaba#noun#2#RM
health_club	helWa_klaba/svAsWya_saMGa#helWa_klaba/svAsWya_saMGa#noun#2#RM
hobby_club	aBiruci_klaba#aBiruci_klaba#noun#2#RM
hockey_club	hoYkI_klaba#hoYkI_klaba#noun#2#RM
holiday_club	paryatana_klaba#paryatana_klaba#noun#2#RM
home_club	AvAsa_saMGa/AvAsa_kenxra#AvAsa_saMGa/AvAsa_kenxra#noun#2#RM
hometown_club	gqha_nagara_saBA/svasWala_saBA#gqha_nagara_saBA/svasWala_saBA#noun#2#RM
homework_club	gqhakArya_klaba#gqhakArya_klaba#noun#2#RM
host_club	mejZabAna_klaba/Ayojana_klaba#mejZabAna_klaba/Ayojana_klaba#noun#2#RM
hunting_club	AKetana_klaba/mqgayA(SikAra)_saMGa#AKetana_klaba/mqgayA(SikAra)_saMGa#noun#2#RM
interest_club	aXikAra_saBA/rUci_klaba/byAja_ekawraNa_kenxra#aXikAra_saBA/rUci_klaba/byAja_ekawraNa_kenxra#noun#2#RM
investment_club	niveSa_samUha#niveSa_samUha#noun#2#RM
jazz_club	jAjZa_saMgIwa_saBA/gIwa_nAtya_samUha#jAjZa_saMgIwa_saBA/gIwa_nAtya_samUha#noun#2#RM
job_club	nOkarI_klaba(kenxra)/sevA(kAma-kZAja)_saMGa/prakaraNa_saBA#nOkarI_klaba(kenxra)/sevA(kAma-kZAja)_saMGa/prakaraNa_saBA#noun#2#RM
journal_club	samAcAra_pawra(sApwAhikayAmAsika)_kenxra#samAcAra_pawra(sApwAhikayAmAsika)_kenxra#noun#2#RM
kennel_club	kuwwA_Gara_saMGa#kuwwA_Gara_saMGa#noun#2#RM
labour_club	Sramika_saBA/majaxUra_saMGa#Sramika_saBA/majaxUra_saMGa#noun#2#RM
league_club	lIga_klaba/saMGa_saBA#lIga_klaba/saMGa_saBA#noun#2#RM
leisure_club	avakASa_manoraMjana_klaba/avakASa_Kela_kUxa_keMxra#avakASa_manoraMjana_klaba/avakASa_Kela_kUxa_keMxra#noun#2#RM
loyalty_club	viSvAsa_saBA/niRTA_kenxra/vaPAxAra(ImAnaxAra)_samAja#viSvAsa_saBA/niRTA_kenxra/vaPAxAra(ImAnaxAra)_samAja#noun#2#RM
lunch_club	laMca_klaba/maXyAnha_Bojana_gqha(keMxra)#laMca_klaba/maXyAnha_Bojana_gqha(keMxra)#noun#2#RM
luncheon_club	OpacArika_aparAhna_Bojana_SAlYA/xopahara_ke_KAne_kA_sWAna#OpacArika_aparAhna_Bojana_SAlYA/xopahara_ke_KAne_kA_sWAna#noun#2#RM
maths_club	mEWsa_klaba/gaNiwa_saBA#mEWsa_klaba/gaNiwa_saBA#noun#2#RM
member_club	saBAsaxa_saMGa#saBAsaxa_saMGa#noun#2#RM
membership_club	saxasyawA_kenxra#saxasyawA_kenxra#noun#2#RM
mendip_club	menxipa_klaba(iMgalEMda_ke_somaraseta_kI_jilA_klaba)#menxipa_klaba(iMgalEMda_ke_somaraseta_kI_jilA_klaba)#noun#2#RM
merseyside_club	marsIsAida_klaba(uwwarI_paScimI_iMglEMda_ke_eka_jile_kA_nAma)#marsIsAida_klaba(uwwarI_paScimI_iMglEMda_ke_eka_jile_kA_nAma)#noun#2#RM
metrology_club	mApa_vixyA_kenxra(klaba)#mApa_vixyA_kenxra(klaba)#noun#2#RM
mineral_club	Kanija_kenxra(klaba)#Kanija_kenxra(klaba)#noun#2#RM
month_club	manWa_klaba/prawimAha_saBA/paMcAMga_mAsa_saBA#manWa_klaba/prawimAha_saBA/paMcAMga_mAsa_saBA#noun#2#RM
motor_club	motara_klaba#motara_klaba#noun#2#RM
motorcycle_club	motara_sAikila_kenxra(klaba)#motara_sAikila_kenxra(klaba)#noun#2#RM
mountaineering_club	parvawArohaNa_klaba(saMGa)#parvawArohaNa_klaba(saMGa)#noun#2#RM
music_club	saMgIwa_saBA#saMgIwa_saBA#noun#2#RM
netball_club	netaboYla_klaba#netaboYla_klaba#noun#2#RM
night_club	nAita_klaba(rAwri_klaba)/nAca-gAne_ke_lie_xera_rAwa_waka_KulA_klaba#nAita_klaba(rAwri_klaba)/nAca-gAne_ke_lie_xera_rAwa_waka_KulA_klaba#noun#2#RM
nightworkers_club	rAwri_kAryakarwA_klaba#rAwri_kAryakarwA_klaba#noun#2#RM
opposition_club	prawipakRa_saBA/viroXI_xala_saMGa#prawipakRa_saBA/viroXI_xala_saMGa#noun#2#RM
owner_club	aXikArI_saMGa/nijI_kenxra#aXikArI_saMGa/nijI_kenxra#noun#2#RM
parent_club	mUla_kenxra/pramuKa_saMGa/muKya_saBA#mUla_kenxra/pramuKa_saMGa/muKya_saBA#noun#2#RM
premiership_club	praXAna_kAryakarwA_kenxra(saMGa)#praXAna_kAryakarwA_kenxra(saMGa)#noun#2#RM
press_club	presa_klaba/muxraNAlaya_saMGa#presa_klaba/muxraNAlaya_saMGa#noun#2#RM
profile_club	bAharI_vyavasWA_kenxra/AkarRaka(lokaCavi)_kenxra#bAharI_vyavasWA_kenxra/AkarRaka(lokaCavi)_kenxra#noun#2#RM
quality_club	guNavawwA_samUha/uwkqRtawA_kenxra#guNavawwA_samUha/uwkqRtawA_kenxra#noun#2#RM
que_club	SIrRa_kenxra#SIrRa_kenxra#noun#2#RM
recreation_club	manoraMjana_klaba/manovinoxa_kenxra#manoraMjana_klaba/manovinoxa_kenxra#noun#2#RM
riding_club	GufasavArI_klaba#GufasavArI_klaba#noun#2#RM
rifle_club	rAiPZala_klaba#rAiPZala_klaba#noun#2#RM
ritz_club	SAnaxAra_klaba/ArAmaxeha_klaba#SAnaxAra_klaba/ArAmaxeha_klaba#noun#2#RM
rock_club	cattAna_para_sWiwa_klaba#cattAna_para_sWiwa_klaba#noun#2#RM
roll_club	GumAvaxAra(vqwwAkAra)_klaba#GumAvaxAra(vqwwAkAra)_klaba#noun#2#RM
rowing_club	nOkAyana(cappU_krIdZA)_klaba#nOkAyana(cappU_krIdZA)_klaba#noun#2#RM
rugby_club	ragbI_PutabAla_klaba#ragbI_PutabAla_klaba#noun#2#RM
sailing_club	(pAla)_nOkAyana_klaba#(pAla)_nOkAyana_klaba#noun#2#RM
salsa_club	sAlasA(nqwya_viXA)_klaba#sAlasA(nqwya_viXA)_klaba#noun#2#RM
school_club	vixyAlaya_klaba(saMGa)#vixyAlaya_klaba(saMGa)#noun#2#RM
science_club	vijFAna_klaba#vijFAna_klaba#noun#2#RM
section_club	saMBAga_kenxra#saMBAga_kenxra#noun#2#RM
single_club	kuMvAre_logoM_ke_liye_klaba#kuMvAre_logoM_ke_liye_klaba#noun#2#RM
snooker_club	snUkara(eka_prakAra_kA_Kela)_klaba#snUkara(eka_prakAra_kA_Kela)_klaba#noun#2#RM
sport_club	Kela_saMGa(klaba)#Kela_saMGa(klaba)#noun#2#RM
sporting_club	Kela_kUxa_klaba(krIdZA_klaba)#Kela_kUxa_klaba(krIdZA_klaba)#noun#2#RM
squash_club	skvEYSa(eka_prakAra_kA_Kela)_klaba#skvEYSa(eka_prakAra_kA_Kela)_klaba#noun#2#RM
stamp_club	dAka_tikata_klaba#dAka_tikata_klaba#noun#2#RM
strip_club	poSAka_keMxra(stripa_klaba)#poSAka_keMxra(stripa_klaba)#noun#2#RM
student_club	vixyArWI_saMGa(klaba)#vixyArWI_saMGa(klaba)#noun#2#RM
study_club	aXyayana_klaba#aXyayana_klaba#noun#2#RM
suicide_club	AwmaGAwa_(ko_rokane_hewu_kAryarawa)_klaba#AwmaGAwa_(ko_rokane_hewu_kAryarawa)_klaba#noun#2#RM
supporter_club	samarWaka_samUha(saMGa)#samarWaka_samUha(saMGa)#noun#2#RM
swimming_club	wErAkI_klaba#wErAkI_klaba#noun#2#RM
teaching_club	SikRaNa_kenxra(aXyApana_klaba)#SikRaNa_kenxra(aXyApana_klaba)#noun#2#RM
tennis_club	tenisa_klaba#tenisa_klaba#noun#2#RM
tower_club	tAvara_klaba/gaganacumbI_klaba#tAvara_klaba/gaganacumbI_klaba#noun#2#RM
travel_club	paryatana_kenxra(klaba)#paryatana_kenxra(klaba)#noun#2#RM
triathlon_club	wIna_krIdAoM[wErAkI_sAikaliMga_raniMga(xOdZa)]_kI_klaba#wIna_krIdAoM[wErAkI_sAikaliMga_raniMga(xOdZa)]_kI_klaba#noun#2#RM
uber_club	viSeRa_SreNI(paxavI)_xene_vAlI_klaba#viSeRa_SreNI(paxavI)_xene_vAlI_klaba#noun#2#RM
ufo_club	yUePao(pahacAna_rahiwa(viciwra)_udZane_vAlA_paxArWa)_klaba#yUePao(pahacAna_rahiwa(viciwra)_udZane_vAlA_paxArWa)_klaba#noun#2#RM
uni_club	yUnivarsitI_klaba#yUnivarsitI_klaba#noun#2#RM
university_club	viSvavixyAlaya_saMGa#viSvavixyAlaya_saMGa#noun#2#RM
village_club	grAma_saMGa(samUha)#grAma_saMGa(samUha)#noun#2#RM
vip_club	vI_AI_pI_klaba(viSiRta_vyakwiyoM_hewu_klaba)#vI_AI_pI_klaba(viSiRta_vyakwiyoM_hewu_klaba)#noun#2#RM
war_club	yuxXa_kenxra#yuxXa_kenxra#noun#2#RM
warehouse_club	BaMdAra(mAla_goxAma)_kenxra#BaMdAra(mAla_goxAma)_kenxra#noun#2#RM
way_club	mArga_(ke_maXya_sWiwa)_klaba(sAXana_kenxra)#mArga_(ke_maXya_sWiwa)_klaba(sAXana_kenxra)#noun#2#RM
web_club	veba_klaba#veba_klaba#noun#2#RM
yacht_club	nOkA_klaba(nOkA_krIdZA_klaba)#nOkA_klaba(nOkA_krIdZA_klaba)#noun#2#RM
youth_club	yuvA_klaba(yUWa_klaba)#yuvA_klaba(yUWa_klaba)#noun#2#RM
access_door	praveSa_mArga_xvAra#praveSa_mArga_xvAra#noun#2#RM
aircraft_door	vAyuyAna_(praveSa)_xvAra#vAyuyAna_(praveSa)_xvAra#noun#2#RM
air_door	vAyu_xvAra(pavana_mArga)#vAyu_xvAra(pavana_mArga)#noun#2#RM
airlock_door	vAyu_avaroXana_xvAra#vAyu_avaroXana_xvAra#noun#2#RM
airport_door	vimAnapawwana_praveSa_xvAra#vimAnapawwana_praveSa_xvAra#noun#2#RM
apartment_door	apArtameMta_xvAra(PlEta_kA_xaravAjA)#apArtameMta_xvAra(PlEta_kA_xaravAjA)#noun#2#RM
attic_door	atArI_xvAra#atArI_xvAra#noun#2#RM
back_door	pICe_kA_xvAra#pICe_kA_xvAra#noun#2#RM
balcony_door	bAlakoYnI_xvAra(Alinxa_kA_xaravAjA)#bAlakoYnI_xvAra(Alinxa_kA_xaravAjA)#noun#2#RM
bar_door	maXuSAlA_(praveSa)_xvAra#maXuSAlA_(praveSa)_xvAra#noun#2#RM
barn_door	KalihAna_kA_xaravAjZA(anAjaGara_xvAra)#KalihAna_kA_xaravAjZA(anAjaGara_xvAra)#noun#2#RM
basement_door	walaGara_xvAra(wahaKAne_kA_xaravAjA)#walaGara_xvAra(wahaKAne_kA_xaravAjA)#noun#2#RM
bathroom_door	snAnaGara_kA_xaravAjA#snAnaGara_kA_xaravAjA#noun#2#RM
bay_door	KAdZI_praveSa_xvAra(mArga)#KAdZI_praveSa_xvAra(mArga)#noun#2#RM
bedroom_door	SayanakakRa_kA_xaravAjA#SayanakakRa_kA_xaravAjA#noun#2#RM
belfry_door	GaMtAGara_kA_xaravAjA#GaMtAGara_kA_xaravAjA#noun#2#RM
blast_door	visPota_hewu_xvAra#visPota_hewu_xvAra#noun#2#RM
boardroom_door	pariRax_kakRa_kA_xaravAjA#pariRax_kakRa_kA_xaravAjA#noun#2#RM
bomb_door	bama_kA_agra_BAga(xvAra)#bama_kA_agra_BAga(xvAra)#noun#2#RM
bow_door	kamAna_(praveSa)_xvAra#kamAna_(praveSa)_xvAra#noun#2#RM
building_door	Bavana_xvAra#Bavana_xvAra#noun#2#RM
cab_door	tEksI(gAdZI)_kA_xaravAjA#tEksI(gAdZI)_kA_xaravAjA#noun#2#RM
cabin_door	kEbina(kakRa)_kA_xaravAjA#kEbina(kakRa)_kA_xaravAjA#noun#2#RM
cabinet_door	alamArI_kA_xaravAjA#alamArI_kA_xaravAjA#noun#2#RM
cafe_door	koYPIGara_kA_xvAra(jalapAnaGara_xvAra)#koYPIGara_kA_xvAra(jalapAnaGara_xvAra)#noun#2#RM
cage_door	piMjare_kA_xaravAjA#piMjare_kA_xaravAjA#noun#2#RM
car_door	kAra_kA_xaravAjZA#kAra_kA_xaravAjZA#noun#2#RM
carriage_door	mAla_dibbe_kA_xaravAjA(mAlavAhaka_gAdZI_xvAra)#mAla_dibbe_kA_xaravAjA(mAlavAhaka_gAdZI_xvAra)#noun#2#RM
casement_door	ParamexAra(PremavAlI)_KidZakI_kA_xaravAjA#ParamexAra(PremavAlI)_KidZakI_kA_xaravAjA#noun#2#RM
castle_door	mahala_praveSa_xvAra#mahala_praveSa_xvAra#noun#2#RM
cat_door	gupwa_xvAra(billI_kA_xaravAjA)#gupwa_xvAra(billI_kA_xaravAjA)#noun#2#RM
cellar_door	wahaKAnA_xvAra(waMga_koTarI_kA_xaravAjA)#wahaKAnA_xvAra(waMga_koTarI_kA_xaravAjA)#noun#2#RM
cell_door	prakoRTa_xvAra#prakoRTa_xvAra#noun#2#RM
centre_door	kenxra_xvAra(bIca_kA_xaravAjA)#kenxra_xvAra(bIca_kA_xaravAjA)#noun#2#RM
ceremony_door	samAroha_praveSa_xvAra#samAroha_praveSa_xvAra#noun#2#RM
chamber_door	kakRa(cEMbara)_kA_xaravAjA#kakRa(cEMbara)_kA_xaravAjA#noun#2#RM
chancel_door	girijAGara_kA_pUrvI_xvAra#girijAGara_kA_pUrvI_xvAra#noun#2#RM
chrome_door	kroma_kA_xaravAjA(pIle_raMga_kA_xaravAjA)#kroma_kA_xaravAjA(pIle_raMga_kA_xaravAjA)#adjective#2#RM
church_door	girajAGara_kA_xvAra#girajAGara_kA_xvAra#noun#2#RM
classroom_door	kakRA_kA_xaravAjA#kakRA_kA_xaravAjA#noun#2#RM
cloister_door	maTa_xvAra#maTa_xvAra#noun#2#RM
closet_door	alamArI(Cote_kamare)_kA_xaravAjA#alamArI(Cote_kamare)_kA_xaravAjA#noun#2#RM
closing_door	kArya_samApwi_xvAra(kisI_kArya_ke_samApana_meM_prayukwa_honevAlA_xaravAjA)#kArya_samApwi_xvAra(kisI_kArya_ke_samApana_meM_prayukwa_honevAlA_xaravAjA)#adjective#2#RM
cockpit_door	(vAyuyAnameM)cAlaka_sWAna_kA_xaravAjA#(vAyuyAnameM)cAlaka_sWAna_kA_xaravAjA#noun#2#RM
conservatory_door	saMrakRikA_gqha_xvAra#saMrakRikA_gqha_xvAra#noun#2#RM
cottage_door	kutIra_xvAra#kutIra_xvAra#noun#2#RM
court_door	nyAyAlaya_(praveSa)_xvAra#nyAyAlaya_(praveSa)_xvAra#noun#2#RM
courtroom_door	nyAyAlaya_kakRa_xvAra#nyAyAlaya_kakRa_xvAra#noun#2#RM
crew_door	cAlaka_xala_hewu_xvAra#cAlaka_xala_hewu_xvAra#noun#2#RM
cubicle_door	GanAkAra_kakRa_kA_xaravAjA#GanAkAra_kakRa_kA_xaravAjA#noun#2#RM
cupboard_door	(CotI)_alamArI_kA_xaravAjA#(CotI)_alamArI_kA_xaravAjA#noun#2#RM
departure_door	prasWAna_xvAra#prasWAna_xvAra#noun#2#RM
driver_door	cAlaka_xvAra#cAlaka_xvAra#noun#2#RM
elevator_door	elivetara(Upara_kI_sIDI)_kA_xvAra#elivetara(Upara_kI_sIDI)_kA_xvAra#noun#2#RM
end_door	anwima_xvAra/samApwi_xvAra(Cora_kA_xaravAjA)#anwima_xvAra/samApwi_xvAra(Cora_kA_xaravAjA)#noun#2#RM
entrance_door	praveSa_xvAra#praveSa_xvAra#noun#2#RM
entry_door	praviRti_xvAra#praviRti_xvAra#noun#2#RM
exit_door	nirgama_xvAra(bAhara_jAne_kA_xaravAjA)#nirgama_xvAra(bAhara_jAne_kA_xaravAjA)#noun#2#RM
factory_door	PEktrI(kAraKAnA)_kA_xaravAjA#PEktrI(kAraKAnA)_kA_xaravAjA#noun#2#RM
farmhouse_door	PArma_hAusa_xvAra#PArma_hAusa_xvAra#noun#2#RM
fire_door	Aga_rokane_ke_liye_banAyA_gayA_xaravAjZA#Aga_rokane_ke_liye_banAyA_gayA_xaravAjZA#noun#2#RM
freezer_door	PrIjara_kA_xaravAjA(himIkaraNa_yanwra_xvAra)#PrIjara_kA_xaravAjA(himIkaraNa_yanwra_xvAra)#noun#2#RM
french_door	PreMca_(kAzca_kI_KidZakI_kA)xaravAjA#PreMca_(kAzca_kI_KidZakI_kA)xaravAjA#noun#2#RM
fridge_door	Prija_kA_xaravAjA#Prija_kA_xaravAjA#noun#2#RM
front_door	muKa_xvAra(Age_kA_xaravAjA)#muKa_xvAra(Age_kA_xaravAjA)#noun#2#RM
furnace_door	BattI_kA_xaravAjA#BattI_kA_xaravAjA#noun#2#RM
gallery_door	galiyAre_kA_xaravAjA#galiyAre_kA_xaravAjA#noun#2#RM
galley_door	powa(samuxrI_powa)_xvAra#powa(samuxrI_powa)_xvAra#noun#2#RM
garage_door	gEreja(motaraKAnA)_kA_xaravAjA#gEreja(motaraKAnA)_kA_xaravAjA#noun#2#RM
garden_door	uxyAna_xvAra#uxyAna_xvAra#noun#2#RM
glass_door	koYca_kA_xaravAjA#koYca_kA_xaravAjA#noun#2#RM
hall_door	saBAgqha_xvAra#saBAgqha_xvAra#noun#2#RM
hangar_door	vimAnaSAlA_xvAra#vimAnaSAlA_xvAra#noun#2#RM
height_door	SiKara_xvAra#SiKara_xvAra#noun#2#RM
hospital_door	cikiwsAlaya_xvAra#cikiwsAlaya_xvAra#noun#2#RM
hostel_door	CAwrAvAsa_xvAra#CAwrAvAsa_xvAra#noun#2#RM
hotel_door	hotala_kA_xaravAjA#hotala_kA_xaravAjA#noun#2#RM
house_door	Gara_kA_xaravAjA#Gara_kA_xaravAjA#noun#2#RM
hutch_door	sanxUka_kA_xaravAjA#sanxUka_kA_xaravAjA#noun#2#RM
hut_door	JoMpadZI_kA_xaravAjA#JoMpadZI_kA_xaravAjA#noun#2#RM
infirmary_door	aspawAla_xvAra#aspawAla_xvAra#noun#2#RM
inn_door	yAwrI_nivAsa(hotala/XarmaSAlA)_kA_xaravAjA#yAwrI_nivAsa(hotala/XarmaSAlA)_kA_xaravAjA#noun#2#RM
iron_door	lohe_kA_xaravAjA#lohe_kA_xaravAjA#noun#2#RM
kennel_door	kuwwA_Gara_kA_xaravAjA#kuwwA_Gara_kA_xaravAjA#noun#2#RM
kitchen_door	rasoIGara_kA_xaravAjA#rasoIGara_kA_xaravAjA#noun#2#RM
lab_door	prayogaSAlA_kA_xaravAjA#prayogaSAlA_kA_xaravAjA#noun#2#RM
laboratory_door	prayogaSAlA_xvAra#prayogaSAlA_xvAra#noun#2#RM
library_door	puswakAlaya_xvAra#puswakAlaya_xvAra#noun#2#RM
lift_door	liPta(bijalI_se_vyakwiyoM_ko_Upara_uTAne_vAlA_yaMwra)#liPta(bijalI_se_vyakwiyoM_ko_Upara_uTAne_vAlA_yaMwra)#noun#2#RM
lounge_door	prawIkRAlaya_kA_xaravAjA#prawIkRAlaya_kA_xaravAjA#noun#2#RM
louvre_door	kalA_saMgrahAlaya_xvAra#kalA_saMgrahAlaya_xvAra#noun#2#RM
mahogany_door	lakadZI_kA_xaravAjA(mahoganI_vqkRa_kI_lakadZI_kA_banA_huA_xaravAjA)#lakadZI_kA_xaravAjA(mahoganI_vqkRa_kI_lakadZI_kA_banA_huA_xaravAjA)#noun#2#RM
metal_door	XAwu_kA_banA_huA_xaravAjA#XAwu_kA_banA_huA_xaravAjA#noun#2#RM
mill_door	kAraKAnA(cakkI/mila)_xvAra#kAraKAnA(cakkI/mila)_xvAra#noun#2#RM
minute_door	sUkRma_xaravAjA#sUkRma_xaravAjA#noun#2#RM
museum_door	saMgrahAlaya_xvAra#saMgrahAlaya_xvAra#noun#2#RM
nursery_door	narsarI_xvAra(pedZa_poXoM_ko_ropane(lagAne)_ke_sWAna_kA_xaravAjA)#narsarI_xvAra(pedZa_poXoM_ko_ropane(lagAne)_ke_sWAna_kA_xaravAjA)#noun#2#RM
office_door	kAryAlaya_kA_xaravAjA#kAryAlaya_kA_xaravAjA#noun#2#RM
opening_door	muKa_xvAra/praWama_avasara#muKa_xvAra/praWama_avasara#noun#2#RM
otter_door	UxabilAva_ke_liye_banA_xaravAjA#UxabilAva_ke_liye_banA_xaravAjA#noun#2#RM
outbuilding_door	upaBavana_xvAra/muKya_Bavana_ke_bAharI_BAga_hewu_banA_xvAra#upaBavana_xvAra/muKya_Bavana_ke_bAharI_BAga_hewu_banA_xvAra#noun#2#RM
oven_door	wanxUra(cUlhA_viSeRa)_kA_xaravAjA#wanxUra(cUlhA_viSeRa)_kA_xaravAjA#noun#2#RM
palace_door	rAjamahala_xvAra#rAjamahala_xvAra#noun#2#RM
panel_door	pattI_kA_xaravAjA#pattI_kA_xaravAjA#noun#2#RM
parlour_door	vArwAkakRa(bETaka)_kA_xaravAjA#vArwAkakRa(bETaka)_kA_xaravAjA#noun#2#RM
passenger_door	yAwrI_xvAra#yAwrI_xvAra#noun#2#RM
patio_door	Azgana_kA_xaravAjA#Azgana_kA_xaravAjA#noun#2#RM
personnel_door	karmacAriyoM_hewu_xvAra#karmacAriyoM_hewu_xvAra#noun#2#RM
platform_door	maMca_xvAra#maMca_xvAra#noun#2#RM
porch_door	barAmaxe_kA_xaravAjA#barAmaxe_kA_xaravAjA#noun#2#RM
presbytery_door	girajAGara_meM_gAyana-sWala_ke_pICe_kA_xaravAjA#girajAGara_meM_gAyana-sWala_ke_pICe_kA_xaravAjA#noun#2#RM
printer_door	priMtara(muxraka)_kA_xaravAjA(hEMdala)#priMtara(muxraka)_kA_xaravAjA(hEMdala)#noun#2#RM
prison_door	kArAgqha_xvAra#kArAgqha_xvAra#noun#2#RM
pub_door	maxirAlaya_xvAra#maxirAlaya_xvAra#noun#2#RM
reception_door	svAgawa_kakRa_xvAra#svAgawa_kakRa_xvAra#noun#2#RM
refrigerator_door	Prija(praSIwaka)_kA_xaravAjA#Prija(praSIwaka)_kA_xaravAjA#noun#2#RM
room_door	kakRa_kA_xaravAjA#kakRa_kA_xaravAjA#noun#2#RM
salon_door	prasAXanAlaya(kalAxIrGA)_kA_xaravAjA#prasAXanAlaya(kalAxIrGA)_kA_xaravAjA#noun#2#RM
saloon_door	SarAbaKAnA(bETaka)_kA_xaravAjA#SarAbaKAnA(bETaka)_kA_xaravAjA#noun#2#RM
school_door	vixyAlaya_xvAra#vixyAlaya_xvAra#noun#2#RM
screen_door	parxe_kA_xvAra(jahAz_parxA_xvAra_kI_waraha_prayukwa_ho)#parxe_kA_xvAra(jahAz_parxA_xvAra_kI_waraha_prayukwa_ho)#noun#2#RM
scullery_door	barwana_sAPa_karane_ke_Cote_kakRa_kA_xaravAjA#barwana_sAPa_karane_ke_Cote_kakRa_kA_xaravAjA#noun#2#RM
security_door	surakRA_xvAra#surakRA_xvAra#noun#2#RM
shop_door	xukAna_kA_xaravAjA#xukAna_kA_xaravAjA#noun#2#RM
side_door	pArSva_xvAra#pArSva_xvAra#noun#2#RM
smokebox_door	cimanI_kA_xaravAjA#cimanI_kA_xaravAjA#noun#2#RM
smoke_door	XUmra_(nikAsI)_xvAra#XUmra_(nikAsI)_xvAra#noun#2#RM
stage_door	maMca_kA_paScaxvAra(maMca_ke_pICe_kA_xvAra)#maMca_kA_paScaxvAra(maMca_ke_pICe_kA_xvAra)#noun#2#RM
station_door	steSana_xvAra#steSana_xvAra#noun#2#RM
steel_door	ispAwa(lohe)_kA_xaravAjA#ispAwa(lohe)_kA_xaravAjA#noun#2#RM
stone_door	pawWara_kA_xaravAjA#pawWara_kA_xaravAjA#noun#2#RM
street_door	sadZaka(galI)_kA_xaravAjA#sadZaka(galI)_kA_xaravAjA#noun#2#RM
studio_door	stUdiyo(prasAra_kakRa)_xvAra#stUdiyo(prasAra_kakRa)_xvAra#noun#2#RM
study_door	aXyayana_kakRa(pATAgAra)_kA_xaravAjA#aXyayana_kakRa(pATAgAra)_kA_xaravAjA#noun#2#RM
style_door	manohArI_xvAra(kalAkqwi_vAlA_xaravAjA)#manohArI_xvAra(kalAkqwi_vAlA_xaravAjA)#noun#2#RM
surgery_door	Salya_cikiwsA_kakRa_xvAra#Salya_cikiwsA_kakRa_xvAra#noun#2#RM
swing_door	GUmane_vAlA_xaravAjA/apane_Apa_banxa_hone_vAlA_xaravAjA#GUmane_vAlA_xaravAjA/apane_Apa_banxa_hone_vAlA_xaravAjA#noun#2#RM
taxi_door	tEksI_kA_xaravAjA#tEksI_kA_xaravAjA#noun#2#RM
temple_door	manxira_xvAra#manxira_xvAra#noun#2#RM
tent_door	wambU_kA_xaravAjA/wambU_meM_banA_kapade_kA_xaravAjA#wambU_kA_xaravAjA/wambU_meM_banA_kapade_kA_xaravAjA#noun#2#RM
terminal_door	aMwima_steSana(tarminala)_para_banA_xaravAjA#aMwima_steSana(tarminala)_para_banA_xaravAjA#noun#2#RM
theatre_door	nAtyaSAlA_xvAra#nAtyaSAlA_xvAra#noun#2#RM
timber_door	kARTa_xvAra/lakadZI_kA_xaravAjA#kARTa_xvAra/lakadZI_kA_xaravAjA#noun#2#RM
toilet_door	SOcAlaya_xvAra#SOcAlaya_xvAra#noun#2#RM
tower_door	mInAra_xvAra#mInAra_xvAra#noun#2#RM
trailer_door	sAmAna_gAdZI(trelara)_kA_xaravAjA#sAmAna_gAdZI(trelara)_kA_xaravAjA#noun#2#RM
train_door	relagAdZI_kA_xaravAjA#relagAdZI_kA_xaravAjA#noun#2#RM
trawl_door	mahAjAla_muKa(maCalI_pakadZane_ke_jAla_kA_agra_BAga)#mahAjAla_muKa(maCalI_pakadZane_ke_jAla_kA_agra_BAga)#noun#2#RM
trunk_door	sanxUka_kA_xaravAjA/suraMga_xvAra#sanxUka_kA_xaravAjA/suraMga_xvAra#noun#2#RM
van_door	vEna(badZI_gAdZI)_kA_xaravAjA#vEna(badZI_gAdZI)_kA_xaravAjA#noun#2#RM
venue_door	Ayojana_sWala_xvAra#Ayojana_sWala_xvAra#noun#2#RM
vestry_door	pUjA_sAmagrI_kakRa_xvAra#pUjA_sAmagrI_kakRa_xvAra#noun#2#RM
wardrobe_door	alamArI_kA_xaravAjA#alamArI_kA_xaravAjA#noun#2#RM
west_door	paScima_xvAra#paScima_xvAra#noun#2#RM
width_door	cOdZAI_vAlA_xaravAjA#cOdZAI_vAlA_xaravAjA#noun#2#RM
wood_door	kARTa_xvAra#kARTa_xvAra#noun#2#RM
yard_door	prAMgaNa(ahAwA)_xvAra#prAMgaNa(ahAwA)_xvAra#noun#2#RM
academy_end	akAxamI_uxxeSya/akAxamI_pariNAma#akAxamI_uxxeSya/akAxamI_pariNAma#noun#2#RM
adaptor_end	anukUliwra_sImA(pariNAma)/anukUliwra_sirA#anukUliwra_sImA(pariNAma)/anukUliwra_sirA#noun#2#RM
adult_end	vayaska_pariNAma(samApwi)#vayaska_pariNAma(samApwi)#noun#2#RM
apparatus_end	upakaraNa_sirA(aMwima_BAga)#upakaraNa_sirA(aMwima_BAga)#noun#2#RM
arse_end	niwaMba_ASraya#niwaMba_ASraya#noun#2#RM
ass_end	mUrKa_kA_aBiprAya(nirarWaka_aBiprAya)#mUrKa_kA_aBiprAya(nirarWaka_aBiprAya)#noun#2#RM
auction_end	nIlAmI_uxxeSya#nIlAmI_uxxeSya#noun#2#RM
ball_end	geMxa_kA_sirA(pariNAma)/kaMxuka_krIdZA_samApwi#geMxa_kA_sirA(pariNAma)/kaMxuka_krIdZA_samApwi#noun#2#RM
bar_end	axAlawa_samApwi/maXuSAlA_samApwi#axAlawa_samApwi/maXuSAlA_samApwi#noun#2#RM
bargain_end	sOxA_pariNAma/lena_xena_aBiprAya#sOxA_pariNAma/lena_xena_aBiprAya#noun#2#RM
barrel_end	belanAkAra_pIpe_kA_aMwima_BAga(sirA)#belanAkAra_pIpe_kA_aMwima_BAga(sirA)#noun#2#RM
bass_end	boYsa(spIkara_niyaMwraNa_yanwra)_kA_aMwima_BAga#boYsa(spIkara_niyaMwraNa_yanwra)_kA_aMwima_BAga#noun#2#RM
baulk_end	boYka(biliyArda_meja)_kA_sirA#boYka(biliyArda_meja)_kA_sirA#noun#2#RM
beach_end	samuxra_wata_kA_Cora(sImA)#samuxra_wata_kA_Cora(sImA)#noun#2#RM
beam_end	kiraNa_puMja_samApwi#kiraNa_puMja_samApwi#noun#2#RM
bearing_end	pahiye_ke_vqwwAkAra_ASraya_kA_sirA(beriMga)#pahiye_ke_vqwwAkAra_ASraya_kA_sirA(beriMga)#noun#2#RM
bedroom_end	Sayana_kakRa_kA_aMwima_BAga(sImA)#Sayana_kakRa_kA_aMwima_BAga(sImA)#noun#2#RM
bench_end	bEMca_(lambI_mejZa)_kA_sirA(aMwima_BAga)#bEMca_(lambI_mejZa)_kA_sirA(aMwima_BAga)#noun#2#RM
blackout_end	blEka_Auta(wimiraNa)_samApwi#blEka_Auta(wimiraNa)_samApwi#noun#2#RM
bowel_end	anwra_samApwi/Azwa_kI_KarAbI#anwra_samApwi/Azwa_kI_KarAbI#noun#2#RM
account_access	leKA_aXigama#leKA_aXigama#noun#2#RM
account_activation	leKA_sakriyaNa#leKA_sakriyaNa#noun#2#RM
account_activity	leKA_gawiviXi-leKA_kriyAnvayana#leKA_gawiviXi-leKA_kriyAnvayana#noun#2#RM
account_administration	leKA_praSAsana#leKA_praSAsana#noun#2#RM
account_administrator	leKA_praSAsaka#leKA_praSAsaka#noun#2#RM
account_advance	leKA_agrima_rASi#leKA_agrima_rASi#noun#2#RM
account_advice	leKA_parAmarSa#leKA_parAmarSa#noun#2#RM
account_age	leKAvaXi#leKAvaXi#noun#2#RM
account_altitude	leKA_unnawAMSa#leKA_unnawAMSa#noun#2#RM
account_amendment	leKA_saMSoXana#leKA_saMSoXana#noun#2#RM
account_application	leKA_Avexana#leKA_Avexana#noun#2#RM
account_area	leKA_kRewra#leKA_kRewra#noun#2#RM
account_aspect	leKA_aBimuKawA#leKA_aBimuKawA#noun#2#RM
account_assistant	leKA_sahAyaka#leKA_sahAyaka#noun#2#RM
account_attempt	leKA_prayawna#leKA_prayawna#noun#2#RM
account_availability	leKA_upalabXawA#leKA_upalabXawA#noun#2#RM
account_balance	leKA_bakAyA#leKA_bakAyA#noun#2#RM
account_basis	leKAXAra#leKAXAra#noun#2#RM
account_beginning	leKA_prAraMBa#leKA_prAraMBa#noun#2#RM
account_book	bahIKAwA#bahIKAwA#noun#2#RM
account_branch	leKA_SAKA#leKA_SAKA#noun#2#RM
account_change	leKA_parivarwana#leKA_parivarwana#noun#2#RM
account_characteristic	leKA_aBilakRaNa#leKA_aBilakRaNa#noun#2#RM
account_child	vaha_baccA_jisake_nAma_para_KAwA_hE#vaha_baccA_jisake_nAma_para_KAwA_hE#noun#2#RM
account_clerk	leKA_lipika#leKA_lipika#noun#2#RM
account_click	leKA-praveSa#leKA-praveSa#noun#2#RM
account_code	leKA_saMhiwA#leKA_saMhiwA#noun#2#RM
account_comment	leKA_tippaNI#leKA_tippaNI#noun#2#RM
account_committee	leKA_samiwi#leKA_samiwi#noun#2#RM
account_company	leKA_kaMpanI#leKA_kaMpanI#noun#2#RM
account_compliance	leKA_anurUpawA#leKA_anurUpawA#noun#2#RM
account_concern	leKA_sambaxXawA#leKA_sambaxXawA#noun#2#RM
account_configuration	leKA_vyavasWApana#leKA_vyavasWApana#noun#2#RM
account_consideration	leKA_vicAraNa#leKA_vicAraNa#noun#2#RM
account_contribution	leKA_yogaxAna#leKA_yogaxAna#noun#2#RM
account_cost	leKA_lAgawa#leKA_lAgawa#noun#2#RM
account_creation	leKA_nirmANa#leKA_nirmANa#noun#2#RM
account_credit	KAwe_meM_jamA_rakama#KAwe_meM_jamA_rakama#noun#2#RM
account_criterion	leKA_mAnaxaMda#leKA_mAnaxaMda#noun#2#RM
account_customer	KAwA_grAhaka#KAwA_grAhaka#noun#2#RM
account_datum	leKA_waWya#leKA_waWya#noun#2#RM
account_deal	leKA_lena_xena#leKA_lena_xena#noun#2#RM
account_dealing	leKA_vinimaya#leKA_vinimaya#noun#2#RM
account_decision	leKA_nirNaya#leKA_nirNaya#noun#2#RM
account_deduction	leKA_katOwI#leKA_katOwI#noun#2#RM
account_deficit	leKA_hAni#leKA_hAni#noun#2#RM
account_department	leKA_viBAga#leKA_viBAga#noun#2#RM
account_depreciation	KAwA_mUlyahrAsa#KAwA_mUlyahrAsa#noun#2#RM
account_dept	leKA_viBAga#leKA_viBAga#noun#2#RM
account_design	leKA_prArUpa#leKA_prArUpa#noun#2#RM
account_detail	leKA_vivaraNa#leKA_vivaraNa#noun#2#RM
account_development	leKA_parivqxXi#leKA_parivqxXi#noun#2#RM
account_difference	leKA_asamAnawA#leKA_asamAnawA#noun#2#RM
account_differential	leKA_aMwaraNa#leKA_aMwaraNa#noun#2#RM
account_director	leKA_nirxeSaka#leKA_nirxeSaka#noun#2#RM
account_diversity	leKA_viviXawA#leKA_viviXawA#noun#2#RM
account_effect	leKA_praBAva#leKA_praBAva#noun#2#RM
account_environment	leKA_pariveSa#leKA_pariveSa#noun#2#RM
account_error	leKA_wruti#leKA_wruti#noun#2#RM
account_estimate	leKA_Akalana#leKA_Akalana#noun#2#RM
account_everything	leKA_samagrawA#leKA_samagrawA#noun#2#RM
account_evidence	leKA_pramANa#leKA_pramANa#noun#2#RM
account_executive	leKA_pravarwaka#leKA_pravarwaka#noun#2#RM
account_experience	leKA_anuBava#leKA_anuBava#noun#2#RM
account_exposure	leKA_KulAsA#leKA_KulAsA#noun#2#RM
account_factor	leKA_kAraka#leKA_kAraka#noun#2#RM
account_feature	leKA_viSeRawA#leKA_viSeRawA#noun#2#RM
account_fee	leKA_Sulka#leKA_Sulka#noun#2#RM
account_feedback	leKA_prawipuRti#leKA_prawipuRti#noun#2#RM
account_field	leKA_kRewra#leKA_kRewra#noun#2#RM
account_fluctuation	leKA_asWirawA#leKA_asWirawA#noun#2#RM
account_form	leKA_prapawra#leKA_prapawra#noun#2#RM
account_function	leKA_kArya#leKA_kArya#noun#2#RM
account_guidance	leKA_nixeSana#leKA_nixeSana#noun#2#RM
account_handler	leKA_prahaswaka#leKA_prahaswaka#noun#2#RM
account_holder	leKA_XAraka#leKA_XAraka#noun#2#RM
account_holiday	leKA_avakASa#leKA_avakASa#noun#2#RM
account_identifier	leKA_aBijFApaka#leKA_aBijFApaka#noun#2#RM
account_imbalance	leKA_asaMwulana#leKA_asaMwulana#noun#2#RM
account_impact	leKA_praBAva#leKA_praBAva#noun#2#RM
account_improvement	leKA_pragawi#leKA_pragawi#noun#2#RM
account_income	leKA_Aya#leKA_Aya#noun#2#RM
account_increase	leKA_vqxXi#leKA_vqxXi#noun#2#RM
account_individual	leKA_viSeRa#leKA_viSeRa#noun#2#RM
account_inequality	leKA_viRamawA#leKA_viRamawA#noun#2#RM
account_inflation	leKA_muxrAsPIwi#leKA_muxrAsPIwi#noun#2#RM
account_influence	leKA_praBAva#leKA_praBAva#noun#2#RM
account_information	leKA_sUcanA#leKA_sUcanA#noun#2#RM
account_innovation	leKA_navInawA#leKA_navInawA#noun#2#RM
account_input	leKA_niveSa#leKA_niveSa#noun#2#RM
account_issue	leKA_viRaya#leKA_viRaya#noun#2#RM
account_knowledge	leKA_jFAna#leKA_jFAna#noun#2#RM
account_lady	vaha_mahilA_jisake_nAma_para_KAwA_hE#vaha_mahilA_jisake_nAma_para_KAwA_hE#noun#2#RM
account_language	leKA_BARA#leKA_BARA#noun#2#RM
account_lesson	leKA_praSikRaNa#leKA_praSikRaNa#noun#2#RM
account_level	leKA_swara#leKA_swara#noun#2#RM
account_login	leKA_AraMBa#leKA_AraMBa#noun#2#RM
account_loss	leKA_kRawi#leKA_kRawi#noun#2#RM
account_maintenance	leKA_anurakRaNa#leKA_anurakRaNa#noun#2#RM
account_management	leKA_prabaMXana#leKA_prabaMXana#noun#2#RM
account_manager	leKA_prabaMXaka#leKA_prabaMXaka#noun#2#RM
account_mandate	leKA_janAxeSa#leKA_janAxeSa#noun#2#RM
account_market	leKA_bAjAra#leKA_bAjAra#noun#2#RM
account_matter	leKA_viRaya#leKA_viRaya#noun#2#RM
account_module	leKA_mApAMka#leKA_mApAMka#noun#2#RM
account_mortgage	leKA_qNa#leKA_qNa#noun#2#RM
account_name	KAwA_nAma#KAwA_nAma#noun#2#RM
account_number	KAwA_saMKyA#KAwA_saMKyA#noun#2#RM
account_office	leKA_kAryAlaya#leKA_kAryAlaya#noun#2#RM
account_owner	leKA_svAmI#leKA_svAmI#noun#2#RM
account_package	leKA_pEkeja#leKA_pEkeja#noun#2#RM
account_page	leKA_pqRTa#leKA_pqRTa#noun#2#RM
account_paragraph	leKA_anucCexa#leKA_anucCexa#noun#2#RM
account_password	leKA_gupwaSabxa#leKA_gupwaSabxa#noun#2#RM
account_payee	leKA_AxAwA#leKA_AxAwA#noun#2#RM
account_payment	leKA_BugawAna#leKA_BugawAna#noun#2#RM
account_people	leKA_janawA#leKA_janawA#noun#2#RM
account_performance	leKA_niRpAxana#leKA_niRpAxana#noun#2#RM
account_period	leKAvaXi#leKAvaXi#noun#2#RM
account_policy	leKA_nIwi#leKA_nIwi#noun#2#RM
account_preference	leKA_prAWamikawA(aXimAna)#leKA_prAWamikawA(aXimAna)#noun#2#RM
account_preparation	leKA_wEyArI#leKA_wEyArI#noun#2#RM
account_price	leKA_mUlya#leKA_mUlya#noun#2#RM
account_process	leKA_prakriyA#leKA_prakriyA#noun#2#RM
account_provider	leKA_saMBaraka#leKA_saMBaraka#noun#2#RM
account_pupil	leKA_praSikRu(sIKanevAlA)#leKA_praSikRu(sIKanevAlA)#noun#2#RM
account_quality	leKA_uwkqRtawA#leKA_uwkqRtawA#noun#2#RM
account_query	leKA_SaMkA#leKA_SaMkA#noun#2#RM
account_reason	leKA_vyAKyA#leKA_vyAKyA#noun#2#RM
account_recommendation	leKA_anumoxana#leKA_anumoxana#noun#2#RM
account_reconciliation	leKA_sAmaMjasya#leKA_sAmaMjasya#noun#2#RM
account_register	leKA_paMjikA#leKA_paMjikA#noun#2#RM
account_representative	leKA_prawiniXi#leKA_prawiniXi#noun#2#RM
account_requirement	leKA_aBiyAcanA#leKA_aBiyAcanA#noun#2#RM
account_response	leKA_prawikriyA#leKA_prawikriyA#noun#2#RM
account_safety	leKA_surakRA#leKA_surakRA#noun#2#RM
account_section	leKA_anuBAga#leKA_anuBAga#noun#2#RM
account_service	leKA_sevA#leKA_sevA#noun#2#RM
account_setting	leKA_samAyojana#leKA_samAyojana#noun#2#RM
account_setup	leKA_rUparacanA#leKA_rUparacanA#noun#2#RM
account_sheet	leKA_pawraka#leKA_pawraka#noun#2#RM
account_side	leKA_pakRa#leKA_pakRa#noun#2#RM
account_size	leKA_parimANa#leKA_parimANa#noun#2#RM
account_software	leKA_soYPtaveyara#leKA_soYPtaveyara#noun#2#RM
account_speed	leKA_gawi#leKA_gawi#noun#2#RM
account_staff	leKA_aXikArIgaNa#leKA_aXikArIgaNa#noun#2#RM
account_status	leKA_sWiwi#leKA_sWiwi#noun#2#RM
account_student	leKA_vixyArWI#leKA_vixyArWI#noun#2#RM
account_suggestion	leKA_suJAva#leKA_suJAva#noun#2#RM
account_surplus	leKA_bacawa#leKA_bacawa#noun#2#RM
account_suspension	leKA_nilambana#leKA_nilambana#noun#2#RM
account_system	leKA_praNAlI#leKA_praNAlI#noun#2#RM
account_teacher	leKA_prAXyApaka#leKA_prAXyApaka#noun#2#RM
account_team	leKA_xala#leKA_xala#noun#2#RM
account_term	leKAvaXi#leKAvaXi#noun#2#RM
account_time	leKA_samaya#leKA_samaya#noun#2#RM
account_today	varwamAna_leKA#varwamAna_leKA#noun#2#RM
account_transaction	leKA_lena_xena#leKA_lena_xena#noun#2#RM
account_transport	leKA_parivahana#leKA_parivahana#noun#2#RM
account_treatment	leKA_praSoXana#leKA_praSoXana#noun#2#RM
account_type	leKA_prakAra#leKA_prakAra#noun#2#RM
account_uncertainty	leKA_asWirawA#leKA_asWirawA#noun#2#RM
account_use	leKA_upayoga#leKA_upayoga#noun#2#RM
account_user	leKA_prayokwA#leKA_prayokwA#noun#2#RM
account_username	leKA_prayokwA_nAma#leKA_prayokwA_nAma#noun#2#RM
account_value	leKA_mUlya#leKA_mUlya#noun#2#RM
account_variable	leKA_parivarwI_rASi#leKA_parivarwI_rASi#noun#2#RM
account_variance	leKA_parivarwanaSIlawA#leKA_parivarwanaSIlawA#noun#2#RM
account_variation	leKA_aMwara#leKA_aMwara#noun#2#RM
account_view	leKA_avalokana#leKA_avalokana#noun#2#RM
account_wear	leKA_kRaya#leKA_kRaya#noun#2#RM
account_weekend	leKA_sapwAhAMwa#leKA_sapwAhAMwa#noun#2#RM
account_woman	mahilA_jisake_nAma_para_KAwA_hE#mahilA_jisake_nAma_para_KAwA_hE#noun#2#RM
account_work	leKA_kArya#leKA_kArya#noun#2#RM
account_worker	leKA_kAryakarwA#leKA_kAryakarwA#noun#2#RM
account_year	leKA_varRa#leKA_varRa#noun#2#RM
activity_accommodation	gawiviXi_sWAna#gawiviXi_sWAna#noun#2#RM
activity_account	gawiviXi_KAwA#gawiviXi_KAwA#noun#2#RM
activity_agenda	gawiviXi_kAryasUcI#gawiviXi_kAryasUcI#noun#2#RM
activity_agreement	gawiviXi_anubaMXa#gawiviXi_anubaMXa#noun#2#RM
activity_analysis	gawiviXi_viSleRaNa#gawiviXi_viSleRaNa#noun#2#RM
activity_area	gawiviXi_sWAna(kRewra)#gawiviXi_sWAna(kRewra)#noun#2#RM
activity_benefit	gawiviXi_lABa#gawiviXi_lABa#noun#2#RM
activity_book	gawiviXi_puswaka#gawiviXi_puswaka#noun#2#RM
activity_booklet	gawiviXi_puswikA#gawiviXi_puswikA#noun#2#RM
activity_break	gawiviXi_avakASa#gawiviXi_avakASa#noun#2#RM
activity_budget	gawiviXi_bajata#gawiviXi_bajata#noun#2#RM
activity_calendar	gawiviXi_paMcAMga-gawiviXi_kEleNdara#gawiviXi_paMcAMga-gawiviXi_kEleNdara#noun#2#RM
activity_cash	gawiviXi_nakaxI#gawiviXi_nakaxI#noun#2#RM
activity_center	gawiviXi_kenxra#gawiviXi_kenxra#noun#2#RM
activity_centre	gawiviXi_kenxra#gawiviXi_kenxra#noun#2#RM
activity_chair	gawiviXi_aXyakRa#gawiviXi_aXyakRa#noun#2#RM
activity_class	gawiviXi_kakRA#gawiviXi_kakRA#noun#2#RM
activity_club	gawiviXi_saMGa#gawiviXi_saMGa#noun#2#RM
activity_code	gawiviXi_sAMkewika_aMka#gawiviXi_sAMkewika_aMka#noun#2#RM
activity_coefficient	gawiviXi_guNAMka#gawiviXi_guNAMka#noun#2#RM
activity_concentration	gawiviXi_wanmayawA(ekAgrawA)#gawiviXi_wanmayawA(ekAgrawA)#noun#2#RM
activity_concern	gawiviXi_sambaxXawA#gawiviXi_sambaxXawA#noun#2#RM
activity_contact	gawiviXi_samparka#gawiviXi_samparka#noun#2#RM
activity_coordinator	gawiviXi_saMyojaka#gawiviXi_saMyojaka#noun#2#RM
activity_course	gawiviXi_viRayavaswu#gawiviXi_viRayavaswu#noun#2#RM
activity_cover	gawiviXi_surakRA#gawiviXi_surakRA#noun#2#RM
activity_cycle	gawiviXi_GatanAcakra#gawiviXi_GatanAcakra#noun#2#RM
activity_datum	gawiviXi_AMkadZA#gawiviXi_AMkadZA#noun#2#RM
activity_day	kriyAkalApa_xivasa#kriyAkalApa_xivasa#noun#2#RM
activity_description	gawiviXi_vyAKyA#gawiviXi_vyAKyA#noun#2#RM
activity_detection	gawiviXi_aBijFAna#gawiviXi_aBijFAna#noun#2#RM
activity_diary	gawiviXi_xinacaryA_pawrikA#gawiviXi_xinacaryA_pawrikA#noun#2#RM
activity_document	gawiviXi_praleKa#gawiviXi_praleKa#noun#2#RM
activity_equipment	gawiviXi_upakaraNa#gawiviXi_upakaraNa#noun#2#RM
activity_focus	gawiviXi_keMxra#gawiviXi_keMxra#noun#2#RM
activity_front	gawiviXi_kAryakRewra#gawiviXi_kAryakRewra#noun#2#RM
activity_ftw	vijaya_hewu_gawiviXi#vijaya_hewu_gawiviXi#noun#1#RM
activity_group	gawiviXi_samUha#gawiviXi_samUha#noun#2#RM
activity_gym	gawiviXi_vyAyAmaSAlA#gawiviXi_vyAyAmaSAlA#noun#2#RM
activity_hall	gawiviXi_kakRa(prakoRTa)#gawiviXi_kakRa(prakoRTa)#noun#2#RM
activity_history	gawiviXi_iwihAsa#gawiviXi_iwihAsa#noun#2#RM
activity_idea	gawiviXi_vicAra#gawiviXi_vicAra#noun#2#RM
activity_impact	gawiviXi_praBAva#gawiviXi_praBAva#noun#2#RM
activity_information	gawiviXi_sUcanA#gawiviXi_sUcanA#noun#2#RM
activity_initiative	gawiviXi_pahala#gawiviXi_pahala#noun#2#RM
activity_instructor	gawiviXi_praSikRaka#gawiviXi_praSikRaka#noun#2#RM
activity_intervention	gawiviXi_haswakRepa#gawiviXi_haswakRepa#noun#2#RM
activity_level	sakriyawA_swara#sakriyawA_swara#noun#2#RM
activity_location	gawiviXi_sWAna#gawiviXi_sWAna#noun#2#RM
activity_manager	gawiviXi_prabaMXaka#gawiviXi_prabaMXaka#noun#2#RM
activity_mat	gawiviXi_catAI#gawiviXi_catAI#noun#2#RM
activity_module	gawiviXi_mApaxaNda#gawiviXi_mApaxaNda#noun#2#RM
activity_newsletter	gawiviXi_sUcanApawra#gawiviXi_sUcanApawra#noun#2#RM
activity_objective	gawiviXi_lakRya#gawiviXi_lakRya#noun#2#RM
activity_operator	gawiviXi_saMcAlaka#gawiviXi_saMcAlaka#noun#2#RM
activity_opportunity	gawiviXi_avasara#gawiviXi_avasara#noun#2#RM
activity_page	gawiviXi_pqRTa#gawiviXi_pqRTa#noun#2#RM
activity_pair	gawiviXi_jodZI#gawiviXi_jodZI#noun#2#RM
activity_part	gawiviXi_hissA#gawiviXi_hissA#noun#2#RM
activity_participation	gawiviXi_sahaBAgiwA#gawiviXi_sahaBAgiwA#noun#2#RM
activity_pattern	gawiviXi_prArUpa#gawiviXi_prArUpa#noun#2#RM
activity_point	gawiviXi_binxu#gawiviXi_binxu#noun#2#RM
activity_profile	gawiviXi_prAleKa#gawiviXi_prAleKa#noun#2#RM
activity_program	gawiviXi_kAryakrama#gawiviXi_kAryakrama#noun#2#RM
activity_programme	gawiviXi_kAryakrama#gawiviXi_kAryakrama#noun#2#RM
activity_project	gawiviXi_pariyojanA#gawiviXi_pariyojanA#noun#2#RM
activity_promotion	gawiviXi_pracAra-gawiviXi_prowsAhana#gawiviXi_pracAra-gawiviXi_prowsAhana#noun#2#RM
activity_provider	gawiviXi_saMBaraka#gawiviXi_saMBaraka#noun#2#RM
activity_pupil	gawiviXi_vixyArWI#gawiviXi_vixyArWI#noun#2#RM
activity_purchase	gawiviXi_KarIxa#gawiviXi_KarIxa#noun#2#RM
activity_purpose	gawiviXi_uxxeSya#gawiviXi_uxxeSya#noun#2#RM
activity_range	gawiviXi_viswAra#gawiviXi_viswAra#noun#2#RM
activity_rate	sakriyawA_xara#sakriyawA_xara#noun#2#RM
activity_recommendation	gawiviXi_anuSaMsA#gawiviXi_anuSaMsA#noun#2#RM
activity_report	gawiviXi_vivaraNa#gawiviXi_vivaraNa#noun#2#RM
activity_result	gawiviXi_pariNAma#gawiviXi_pariNAma#noun#2#RM
activity_return	gawiviXi_prawiPala#gawiviXi_prawiPala#noun#2#RM
activity_room	gawiviXi_kakRa#gawiviXi_kakRa#noun#2#RM
activity_section	gawiviXi_anuBAga#gawiviXi_anuBAga#noun#2#RM
activity_service	gawiviXi_sevA#gawiviXi_sevA#noun#2#RM
activity_session	gawiviXi_sawra#gawiviXi_sawra#noun#2#RM
activity_sheet	gawiviXi_pawraka#gawiviXi_pawraka#noun#2#RM
activity_side	gawiviXi_pakRa#gawiviXi_pakRa#noun#2#RM
activity_space	gawiviXi_sWAna#gawiviXi_sWAna#noun#2#RM
activity_state	gawiviXi_sWiwi#gawiviXi_sWiwi#noun#2#RM
activity_step	gawiviXi_kaxama(krama)#gawiviXi_kaxama(krama)#noun#2#RM
activity_strategy	gawiviXi_yojanA#gawiviXi_yojanA#noun#2#RM
activity_student	gawiviXi_vixyArWI#gawiviXi_vixyArWI#noun#2#RM
activity_system	gawiviXi_waMwra#gawiviXi_waMwra#noun#2#RM
activity_tel	gawiviXi_telIPona#gawiviXi_telIPona#noun#2#RM
activity_term	gawiviXi_avaXi-gawiviXi_kAla-gawiviXi_Sabxa#gawiviXi_avaXi-gawiviXi_kAla-gawiviXi_Sabxa#noun#2#RM
activity_test	gawiviXi_jAzca#gawiviXi_jAzca#noun#2#RM
activity_therapy	gawiviXi_upacAra#gawiviXi_upacAra#noun#2#RM
activity_time	gawiviXi_samaya(avaXi)#gawiviXi_samaya(avaXi)#noun#2#RM
activity_title	gawiviXi_SIrRaka#gawiviXi_SIrRaka#noun#2#RM
activity_tutorial	gawiviXi_SikRaNa#gawiviXi_SikRaNa#noun#2#RM
activity_type	gawiviXi_prakAra#gawiviXi_prakAra#noun#2#RM
activity_unit	sakriyawA_IkAI#sakriyawA_IkAI#noun#2#RM
activity_value	sakriyawA_mahawwva#sakriyawA_mahawwva#noun#2#RM
activity_visit	gawiviXi_xOrA(yAwrA)#gawiviXi_xOrA(yAwrA)#noun#2#RM
activity_waste	gawiviXi_apavyaya#gawiviXi_apavyaya#noun#2#RM
activity_week	gawiviXi_sapwAha#gawiviXi_sapwAha#noun#2#RM
activity_weekend	gawiviXi_sapwAhAnwa#gawiviXi_sapwAhAnwa#noun#2#RM
activity_worker	gawiviXi_karmacArI#gawiviXi_karmacArI#noun#2#RM
activity_www	gawiviXi_vESvika-wanwra(saMracanA)#gawiviXi_vESvika-wanwra(saMracanA)#noun#2#RM
activity_year	gawiviXi_varRa#gawiviXi_varRa#noun#2#RM
