#computer science dictionary extracted from Bharatvani site by Prashant. Formatted by Roja (03-10-2019)
#Changes:: 1) Separated single word and multi words into separate dictionaries
#          2) English words are converted to lower case
#          3) Added category as 'noun' by default
#################################################################################
abacus_noun	ebekasa/ninawArA
abort_noun	viPalana
abstract_noun	sArAMSa/amUrwa
abstracting_noun	sArAMSana/amUrwakaraNa/sArAharaNa
accent_noun	uccAraNa_cihna
access_noun	aBigama
accounting_noun	leKA_kArya
accumulator_noun	saMcAyaka
accuracy_noun	pariSuxXawA
acronym_noun	parivarNI_Sabxa
action_noun	kriyA
activation_noun	sakriyaNa
active_noun	sakriya
activity_noun	sakriyawA
adaptability_noun	anukUlanIyawA
adapter_noun	anukUliwra
addend_noun	yojya
adder_noun	yojaka
address_noun	pawA
addressing_noun	pawABigamana
adjacency_noun	saMlagnawA
adjust_noun	samAyojana
aerial_noun	eriyala
aggregate_noun	puMja
algol_noun	ElgoYla
algorithm_noun	kalana_viXi/elgoriWma
alias_noun	apara
aliasing_noun	upaGatana
alignment_noun	sareKaNa
allocate_noun	niyawana
alphabetization_noun	varNAnukramaNa
alphageometrics_noun	akRarAwmaka_jyAmiwikI
alphameric_noun	akRarAMkIya
alphamosaic_noun	alPAmojeka
alphanumeric_noun	akRarAMkIya
altering_noun	parivarwana
analog_noun	anurUpa
and_noun	waWA
annotation_noun	tippaNa
annunciator_noun	AKyApiwra
appendage_noun	anubaMXa
applique_noun	aXiropaNa
arbitration_noun	maXyasWa
architecture_noun	vAswukalA/sWApawyakalA
archiving_noun	purABaMdAraNa
argument_noun	svawaMwra_cara
array_noun	saraNI
ascender_noun	Arohaka
ascil_noun	AskI
aspect_noun	aBimuKawA
assemble_noun	kodZAMwaraNa
assembler_noun	kodAMwaraka
assembling_noun	kodAMwaraNa
assembly_noun	kodAMwaraNa
asynchronous_noun	awulyakAlika/_awulyakAlI
attenuation_noun	kRINana
attenuator_noun	kRINakArI
attribute_noun	guNa
augend_noun	yojaka
augment_noun	saMvarWa
augmenter_noun	saMvarXaka
author_noun	saMleKaka
authoring_noun	saMleKana
authority_noun	prAXikAra
autoanswer_noun	svawaH_uwwariwra
autoflow_noun	svawaH_pravAha
automata_noun	svacala_prarUpa
automation_noun	svacAlana/svacAliwa_yaMwra
automatisation_noun	svacAlanIkaraNa
automaton_noun	svacala_prarUpa
automoniter_noun	svamoYnitara
autoplotter_noun	svawaH_AleKiwra
availability_noun	prApyawA
b-tree_noun	ba-warU
background_noun	pqRTaBUmi
backspace_noun	paScIyana
backspacing_noun	paScIyana
backtracking_noun	paSca_anumArgaNa
backup_noun	pUrwikara
balance_noun	saMwulana/SeRa
band_noun	bEMda/pattI
bandpass_noun	bEMda_pAraka
bandwidth_noun	bEMda_cOdZAI
base_noun	AXAra
basic_noun	besika
batch_noun	pracaya
batching_noun	pracayana
baud_noun	boYdZa
bead_noun	kiraNa_puMja_vikRepaNa
beat_noun	prAraMBana
begin_noun	prAraMBana_KaMdaka
bellfast_noun	belaPAsta
bias_noun	aBinawi
bibliography_noun	graMWa_sUcI
bid_noun	bolI
bifurcation_noun	xviSAKana
binary_noun	xvi-AXArI
binarycoding_noun	xvi-AXArI_kUtaleKana
bind_noun	baMXana
binding_noun	baMXana
bionics_noun	bAyonikI/jEva_ilektrAnikI
bipolar_noun	xviXruvI
bistable_noun	xvisWiwika
bisynchronous_noun	xvi-wulyakAlika
bit_noun	xvayaMya/bita
blank_noun	rikwa
blanking_noun	lopana
blast_noun	sPotana
bleed_noun	sravaNa
blind_noun	aMXa
blinking_noun	timatimAnA
block_noun	KaMdaka
blockette_noun	KaMdikA
blocking_noun	KaMdakIyana/avaroXana
blow_noun	Pullana
blowing_noun	Pullana
book_noun	pqRTiwa_smqwi
bouncing_noun	ucCalana
bound_noun	paribaMXa
boundary_noun	parisImA
branch_noun	SAKA
branching_noun	SAKana
break_noun	vicCexa
bridgeware_noun	sewu_sAmagrI
bridging_noun	sewu_baMXana
bucket_noun	samUha/bakata
buffer_noun	cayaka
buffering_noun	cayakana
bug_noun	xoRa
buggy_noun	baggI
bus_noun	basa
bussback_noun	paScaBaraNa
byproduct_noun	upowpAxa
byte_noun	bAita
cable_noun	kebala
cache_noun	kESe/xruwikA
calculation_noun	parikalana
calculator_noun	parikaliwra
call_noun	AhvAna
calling_noun	Aha_vAna
cancel_noun	nirasana
capacity_noun	kRamawA
capstan_noun	kEpstana/tepacAlaka_cakra
capture_noun	pragrahaNa
card_noun	pawraka/kArda
caret_noun	kErata
carousel_noun	GUrNiwra
carriage_noun	vAhana
carrier_noun	vAhaka
carry_noun	haswaMgawa/hAsila
cartridge_noun	AgutikA
cassette_noun	kEseta/petikA
catalogue_noun	kramAxeSa_sUcI
catena_noun	kEtInA/SqMKalA
catenate_noun	SqMKaliwa
cell_noun	koRTikA
centering_noun	kenxraNa
chad_noun	tikalI
chain_noun	SqMKalA
chaining_noun	SqMKalana
channel_noun	cEnala/praNAla
channel-attached_noun	praNAla_saMlagna
character_noun	saMprawIka
character-deletion-character_noun	saMprawIka-vilopI_saMprawIka
characteristic_noun	aBilakRaNika
chart_noun	saMciwra
chassis_noun	nyAXAra
chip_noun	cipa/etalikA
cipher_noun	bIja_leKa/sAiPara
circuit_noun	paripaWa
citation_noun	ulleKa
cladding_noun	pariniXAna
class_noun	varga
classification_noun	vargikaraNa
clear_noun	mArjana
clipping_noun	karwana
clock_noun	kAlaxa_paripaWa
clocking_noun	samAyojana
cluster_noun	gucCa
co-resident_noun	saha_nivAsI
co-routine_noun	sahanemakA
coalesce_noun	saMlayana
cobol_noun	kobola
codasyl_noun	kodAsila
code_noun	kUta/koda
coder_noun	kodiwra
coding_noun	kUtaleKana/kodana
collate_noun	samAnukramaNa
collator_noun	samAnukramiwra
collision_noun	saMGatta
column_noun	swaMBa
combination_noun	saMcaya/saMyojana
combiner_noun	saMyojaka
command_noun	samAxeSa/kamAMda
comment_noun	tippaNI
communality_noun	sAmuxAyikawA
communication_noun	saMcAra
companding_noun	saMpIdana_prasAraNa
compandor_noun	saMpIdana_prasAriwra
comparator_noun	wulaniwra/wulanaka
compatibility_noun	susaMgawi/saMgawawA
compatible_noun	susaMgawa
compilation_noun	anuBARaNa
compile_noun	anuBARaNa
compiler_noun	anuBARaka
compiler-compiler_noun	anuBARaka-anuBARaka
complement_noun	pUraka
complement-on-nine_noun	nava-pUraka
complement-on-two_noun	xo-pUraka
complementer_noun	pUrakiwra
complementing_noun	pUrakIkaraNa
component_noun	Gataka
compress_noun	saMpIdana
compressor_noun	saMpIdiwra
computability_noun	aBikalanIyawA
computation_noun	aBikalana
computer_noun	kaMpyUtara/aBikaliwra
computerist_noun	aBikaliwravixa
computerization_noun	aBikaliwrIkaraNa/kaMpyUtarIkaraNa
concatenate_noun	saMSqMKalana
concatenation_noun	saMSqMKalana
concentration_noun	saMkeMxraNa
concentrator_noun	saMkeMxriwra
concordance_noun	susaMgawawA
concordant_noun	susaMgawa/susvara
concurrent_noun	saMgAmI
conditional_noun	prawibaMXI_vicCexa_biMxu
conditioning_noun	prawibaMXana/prAnukUlana
confidentiality_noun	gopanIyawA
configuration_noun	vinyAsa
confirmation_noun	saMpuRti
congestion_noun	saMkulana
conjunction_noun	sarvaniRTa
connection_noun	saMbaMXana
connective_noun	saMyojaka
connector_noun	saMbaMXaka
consecutive_noun	kramAgawa
console_noun	kansola
consolidation_noun	samekana
consolidator_noun	samekiwra
constraint_noun	vyavaroXa
content_noun	anwarvaswu/aMSa
contention_noun	prayoga_prawisparXA
context_noun	saMxarBa
contrast_noun	viparyAsa/vyawireka
control_noun	niyaMwraNa
controller_noun	niyaMwriwra/niyaMwraka
convention_noun	rUDZi/paripAtI
convergence_noun	aBisAriwA
conversation_noun	saMvAxa
conversational_noun	saMvAxI
conversion_noun	rUpAMwaraNa
convert_noun	rUpAMwaraNa
converter_noun	parivarwaka
copy_noun	prawilipi
core_noun	kroda
correction_noun	saMSoXana
count_noun	ginawI/gaNanA/gaNanAMka
counter_noun	gaNiwra
crowding_noun	aXisaMKyana
cryogenics_noun	nimnawApikI
cryostat_noun	nimnawApasWApI
cryotron_noun	krAyotrAna/nimnawApI_sciva
cryptographic_noun	gUDZAleKI
cryptography_noun	gUDZaleKana/gUDZaleKikI
cursor_noun	prasaMkewaka
curtate_noun	laXvakRa
cushion_noun	walpa
cybernation_noun	sAibaraneSana/aBikaliwrI_svacalana
cybernetics_noun	sAibaranetiksa/sUcanA_praBAvikI
cycle_noun	cakra
damping_noun	avamaMxana
data_noun	AzkadZe
database_noun	AzkadZAsaMcaya
datagram_noun	AzkadZAreKa
datamation_noun	AzkadZA_svacAlana
dataphone_noun	detAPona
datatron_noun	detAtrAna
datum_noun	AXAra//AzkadZA
deactivation_noun	niRkriyaNa
deblock_noun	viKaMdakana
debug_noun	xoRamArjana
debugger_noun	xoRamArjaka
decade_noun	xaSaka
decibel_noun	desibela
decidability_noun	nirNeyawA
decipher_noun	kUtavAcana
decision_noun	nirNaya
decoder_noun	vikodaka/kUtavAcaka
decollate_noun	visamAnukramaNa
decollator_noun	visamAnukramaka
deconcentration_noun	visaMkenxraka
decrement_noun	apakRaya/hrAsa
decrypt_noun	viguDZana
decurl_noun	vakramArjana
default_noun	vyawikrama/cuka
degauss_noun	vikRewraNa
degausser_noun	vikRewraka
degeneracy_noun	apaBraRtawA
delay_noun	vilaMba
delayline_noun	vilaMba_lAina
delete_noun	vilopa/vilopana
delimiter_noun	parisImaka
demand_noun	mAMga
demodulation_noun	vimAdulana
demodulator_noun	vimAdulaka
demount_noun	avarohaNa
demultiplexing_noun	vibahusaMkewana
density_noun	saGanawA/Ganawva
deque_noun	vipaMkwIyana
derning_noun	nayUnana_kRamawA
descender_noun	avarohaka
description_noun	varNana
descriptor_noun	nirUpaka
design_noun	aBikalpanA
despatch_noun	preRaNa
destination_noun	gaMwavya
destrucaddition_noun	vinASI_yoga
detab_noun	visAraNIyana
detap_noun	vitEpana
device_noun	yukwi
device-dependent_noun	yukwi_ASriwa
diagnosis_noun	nixAna
diagnostics_noun	nixAnikI
diagram_noun	AreKa
dial_noun	dAyala
dial-up_noun	dAyalana
dialing_noun	dAyalana
dialog_noun	saMvAxa
dibit_noun	xvixvayaMka
dichotomy_noun	xviBAjana
dictionary_noun	koSa
differentiator_noun	avakalaka
digit_noun	aMka
digitization_noun	aMkarUpaNa
digitize_noun	aMkarUpaNa/aMkIkaraNa
digitizer_noun	aMkarUpaka
digroup_noun	aMkAwmaka_samUha
dimension_noun	vimA
diplexer_noun	xvisaMkewaka
directive_noun	nirxeSa
directory_noun	nirxeSikA
disaggregation_noun	vipuMjana
disassembler_noun	vikoMdAwaraka
disassembly_noun	saMprawIka_vikodAMwaraNa
discretization_noun	asaMwawakaraNa
discriminator_noun	vivikwakara
disjunction_noun	sammilana
disk-based_noun	cakrikA_AXAriwa_pracAlana
diskette_noun	namyikA/diskata
dispatch_noun	preRaNa
dispatcher_noun	preRaka
dispersion_noun	parikRepaNa
distortion_noun	virUpaNa
diversity_noun	viBinnawA/viviXawA
divisor_noun	BAjaka
document_noun	praleKa
documentation_noun	praleKana
docuterm_noun	praleKa_sUcaka
dopant_noun	mAxaka_paxArWa
double-word_noun	xviSabxa
dragging_noun	karRaNa
drift_noun	apavAha
duality_noun	xvEwI
dump_noun	sannikRepa
duodecimal_noun	xvAxaSa_AXArI
duplexing_noun	xvEXIkaraNa/xvisaMkewana
duplicator_noun	anulipiwra
edge_noun	kora
edit_noun	saMpAxana
editor_noun	saMpAxaka
edulcorate_noun	SoXana
element_noun	avayava
emboldening_noun	anyaWA_anucCexa_niyama
emulate_noun	rikwa_rajju
emulation_noun	yaMwrAnukaraNa
enable_noun	samarWakaraNa
enabled_noun	samarWakqwa
encipher_noun	kUtaleKana
encode_noun	kodana/kUtaleKana
encoder_noun	kodiwra/kUtaleKiwra
encryption_noun	guDZaleKana
english_noun	Hindi
enter_noun	praveSa
environment_noun	pariveSa
epilog_noun	upasaMhAra
equalizer_noun	wulyakAraka
equipment_noun	upakaraNa
equivalence_noun	wulyawA
equivocation_noun	bahu-arWawA_nivAraNa
erase_noun	vyAmArjana
erlang_noun	iralEMga
exception_noun	apavAxa
exclusion_noun	apavarjana
exclusive-or_noun	apavarjI_'aWavA'
execute_noun	niRpAxana
execution_noun	niRpAxana
extension_noun	viswAra/viswqwi
extract_noun	niRkarRa
extraction_noun	niRkarRaNa
extractor_noun	niRkarRaka
facsimile_noun	prawikqwi
fan-in_noun	niveSAMka
fetch_noun	Anayana
firmware_noun	prakriyA_yaMwra_sAmagrI
flag_noun	pawAkA/cihnaka
flippy_noun	xvipArSva_namyikA
fluidic_noun	waralI
fluidics_noun	waralikI
flyback_noun	prawiXAva
folding_noun	valana
font_noun	PAMta
footer_noun	pAxikA
fork_noun	xviSAKa
forking_noun	xviSAKana
format_noun	saMrUpa/PoYrmeta
formatter_noun	saMrUpaka
forth_noun	PorWa
fortran_noun	PortrAna
four-wire_noun	cAra_wAra
frame_noun	Prema/swaMBa
framing_noun	Premana/swaMBa_sarjana
frequency_noun	Avqwi/bAraMbArawA
function_noun	Palana/prakArya
garbage_noun	kacarA
gate_noun	xvAra
geo-stationary_noun	BUsWira
glitch_noun	Xvanika
grammar_noun	vyAkaraNa
gulp_noun	bAita_samUha
half-adder_noun	arXa_yojaka
half-carry_noun	arXa-haswaMgawa
half-duplex_noun	arXa-xvEXa
half-speed_noun	arXa_cAla
half-subtracter_noun	arXa-vyavakalaka
half-word_noun	arXa-Sabxa
handler_noun	haswaka
hard-wired_noun	sWAyI_wAra_saMbaxXa
hardware_noun	yaMwrasAmagrI
hardwiring_noun	sWAyI_wAra_saMbaMXana
hash_noun	xruwAnveRaNa
hashing_noun	xruwAnveRaNa
header_noun	praveSikA
heading_noun	SIrRaka
hesitation_noun	alparoXa
heuristic_noun	svAnuBavika
hexadecimal_noun	RodaSa_AXArI
hierarchy_noun	paxAnukrama
highway_noun	mahAmArga
hiragana_noun	hIrAgAnA
hit_noun	lakRya_veXa/prahAra/kRoBaja
hologram_noun	hologrAma
homeostatis_noun	samasWApana
hopper_noun	pluwi_maMjURA
host_noun	AwiWeya
hub_noun	nABi
hunting_noun	AKoja
identifier_noun	aBijFApaka
identity_noun	aBijFApana
if-then-else_noun	yaxi_waxA_anyaWA'
ignore_noun	upekRA_anuxeSa
image_noun	prawibiMba
implication_noun	vivakRA
imprinter_noun	CApiwra
imprinting_noun	CApana
impulse_noun	Avega
inclusion_noun	aMwarveSa/aMwarveSana
inconnector_noun	aBisaMbaMXaka
increment_noun	vqxXi
incrementer_noun	varXiwra
indegree_noun	aMwaHkoti
indent_noun	aBisWApana
indexing_noun	sUcIkaraNa
indicator_noun	sUcaka
informatics_noun	sUcanA_vijFAna/sUcanikI
information_noun	sUcanA
initialization_noun	prAraMBikIkaraNa
initialize_noun	prAraMBikIkaraNa_karanA
inking_noun	aMkana
inquiry/reply_noun	pUCawACa/uwwara
inscribe_noun	cirAMkana
insert_noun	niveSana
instruction_noun	anuxeSa
interaction_noun	anyonyakriyA
intercycle_noun	aMwarAcakra
interface_noun	aMwarApqRTa
interfix_noun	aMwarlagna
interlanguage_noun	aMwaraBARA
interleave_noun	aMwaHpawraNa
interleaving_noun	aMwaHpawraNa
interlude_noun	viRkaMBaka
interpositioning_noun	aMwarAsWApana
interpreter_noun	nirvacaka
interrobang_noun	aXimuxraNa
interrogating_noun	praSnasaMcAraNa
interrogation_noun	praSnana
interrogator_noun	praSniwra
interworking_noun	aMwarA_pracAlana
intimate_noun	GaniRTa_saMparka
invert_noun	prawilomana
inverter_noun	prawilomiwra
invocation_noun	uwkriyaNa
invoke_noun	uwkriya_karanA
irrelevance_noun	asaMgawi
iterate_noun	punarAvarwana
iteration_noun	punarAvqwwi
jack_noun	saMyojaka
jitter_noun	AkaMpa
joggle_noun	susWiwikaraNa
join_noun	sammilana
journal_noun	yaWArUpa
journaling_noun	yaWArUpawA
jumper_noun	JaMpaka
junctor_noun	saMXika
junk_noun	kabAdZa
justification_noun	Ociwya
kanji_noun	kaMjI_varNamAlA
katakna_noun	katakanA_varNamAlA
kerning_noun	nyUnana_kRamawA
key-driven_noun	kuMjI-paricAliwa
key-to-disk_noun	kuMjI_se_cakrikA
keyboard_noun	kuMjIpatala
kilobaud_noun	kilovoYda
kilobyte_noun	kilobAita
kilomega_noun	kilomegA
label_noun	lebala
labelling_noun	lebanala
latch_noun	sitakanI
latching_noun	sitakana
leader_noun	agraga
leasing_noun	pattAyana
leg_noun	pAxa
length_noun	laMbAI
letter_noun	akRara
level_noun	swara
lexeme_noun	Sabxima
lexicon_noun	Sabxa_koSa
librarian_noun	kramAxeSa_saMgrAhaka
library_noun	kramAxeSa_saMgraha
limiter_noun	sImaka
line_noun	lAina/reKA
linearity_noun	rEKikawA
lines-per-inch_noun	prawi_iMca_reKAez
link_noun	kadZI
link-attached_noun	kadZIbaxXa
linkage_noun	SqMKalana
linker_noun	SqMKalaka
listing_noun	sUcIyana
literal_noun	AkRara
load_noun	BAra/loda
load-on-call_noun	AhvAnI_BAraNa
loader_noun	BAraka
loading_noun	BAraNa
lobe_noun	pAli
local_noun	sWAnIya/sWAnika
locate_noun	sWAna_nirXAraNa
location_noun	sWAna/sWAna_nirXAraNa
lock_noun	wAlakana/wAlaka
locking_noun	wAlakana
log_noun	pracAlana_aBileKa
logger_noun	pracAleKiwra
logging_noun	pracAleKana
look-up-table_noun	avalokana_sAraNI
loop_noun	pASa
looping_noun	pASana
loss_noun	hAni/kRINana
machine_noun	yaMwra/maSIna
macroargument_noun	sWUla_svawaMwra_cara
macroassembler_noun	sWUla_kodAMwaraka
macrocall_noun	sWUla_AhvAna
macrocode_noun	sWUla_kUta
macrocoding_noun	sWUla_kUtaleKana
macrocommand_noun	sWUla_samAxeSa
macrodeclaration_noun	sWUla_GoRaNA
macrodefinition_noun	sWUla_pariBARA
macroelement_noun	sWUla_avayava
macroexerciser_noun	sWUla_parIkRaka
macroexpansion_noun	sWUla_prasAra
macroflowchart_noun	sWUla_pravAha_saMciwra
macrogeneration_noun	sWUla_janana
macrogenerator_noun	sWUla_janiwra
macroinstruction_noun	sWUla_anuxeSa
macrolibrary_noun	sWUla_kramAxeSa_saMgraha
macroparameter_noun	sWUla_prAcala
macroprogramming_noun	sWUla_kramAxeSana
macroprototype_noun	sWUla_AxiprarUpa
macrosystem_noun	sWUla_waMwra
macrotrace_noun	sWUla_wruti_saMsUcana
macsyma_noun	mEkasAimA
madcap_noun	mEdakEpa
mag_noun	mEga/sWUla_janiwra
magnetostriction_noun	cuMbakIya_virUpaNa
mainframe_noun	aXisaMsAXiwra/bqhaw_aBikAliwra
majority_noun	bahusaMKyaka
management_noun	prabaMXa
manifolding_noun	bahu-prawilipIyana
marge_noun	vilaya
margin_noun	upAMwa
mark_noun	cihna/uccaga
marker_noun	cihnaka
marking_noun	cihna/uccaga
maser_noun	mesara
mask_noun	AcCaxa
massaging_noun	parimArjana
master_noun	praWAna
match_noun	sumelana
matrix_noun	mEtriksa/AvyUha
megabyte_noun	megAbAita
megacycle_noun	megAsAikila
memory_noun	smqwi
menu_noun	menU/prasUcI
merging_noun	vilayana
messaging_noun	saMxeSa_preRaNa
metasystem_noun	aXiwaMwra
microcobol_noun	mAikrokobola
microcomputer_noun	sUkRma_aBikaliwra
microcycle_noun	sUkRma_cakra
microfiche_noun	sUkRmikA
microfilm_noun	mAikroPilma
microfloppy_noun	sUkRma_namyikA
microflowchart_noun	sUkRma_pravAha_saMciwra
micrographics_noun	sUkRmAleKikI
microimage_noun	sUkRma_prawibiMba
micromainframe_noun	sUkRma_aXisaMsAXiwra/sUkRma_bqhaw_aBikaliwra
microminiaturization_noun	sUkRma_laGurUpaNa
microorder_noun	sUkRmAxeSa
microphotograph_noun	sUkRma_PotogrAPa
microphotography_noun	sUkRma_PotogrAPI
microprocessor_noun	sUkRma_saMsAXiwra
microprogram_noun	sUkRma_kramAxeSa/sUkRmAxeSa
microsequence_noun	sUkRma_anukrama
middleware_noun	maXyama_sAmagrI
midicomputer_noun	maXyama_aBikaliwra
migration_noun	pravAsana
minicomputer_noun	laGu_aBikaliwra
minidiskette_noun	laGu_namyikA
minterm_noun	guNaxa
mips_noun	mipsa
misfeed_noun	kuBaraNa
misregistration_noun	kupaMjIpana
mistake_noun	BUla
mnemonic_noun	smaraka
modifier_noun	Aparivarwaka
modula_noun	mAdulA
modularity_noun	prawirUpakawA
monadic_noun	eka-aka
monostable_noun	ekasWiwika
morpheme_noun	rUpima
morphism_noun	AkAriwA
mount_noun	Aroha
move_noun	aMwaraNa/cAla
multiaspect_noun	bahuvI
multibus_noun	bahubasa
multichip_noun	bahu_patalikA
multilinked_noun	bahu_SqMKaliwa
multiplexer_noun	bahusaMkewaka
multiplexing_noun	bahusaMkewana/bahuBAjana
multipriority_noun	bahu_prAWamikawA
multiprocessing_noun	bahu_saMsAXana
multiprocessor_noun	bahu_saMsAXiwra
multiprogramming_noun	bahu_kramAxeSana
multistation_noun	bahu_keMxra
multithreading_noun	bahu_sUwraNa
multivibrater_noun	bahukaMpiwra
name_noun	nAma/nAmakaraNa
nand_noun	waWA_pUraka'
needle_noun	sUI
negate_noun	niReXa_kriyA
negentropy_noun	sUcanA_entroYpI
neper_noun	nepara
nexus_noun	grAMWi
nibble_noun	cawuHxXayaMka/nibala
nip_noun	nipa
no-op_noun	saMkriyAhIna_anuxeSa
no-operation_noun	saMkriyAhIna_anuxeSa
non-compact_noun	asaMhawa
non-conjunction_noun	waWApUraka
non-determinism_noun	anirXAriwA
non-disjunction_noun	aWavA_pUraka
non-interactive_noun	anyonyakriyAhIna
non-locking_noun	awAlakana
non-reusable_noun	punaH_aprayojya
nor_noun	aWavA_pUraka'
normalize_noun	prasAmAnyIkaraNa
normalizer_noun	prasAmAnyaka
not_noun	pUraka'
not-and_noun	waWA_pUraka'
not-or_noun	aWavA_pUraka'
nybble_noun	cawuHxvayaMka/nibala
octonary_noun	aRtAXArI
off-line_noun	lAinewara
off-time_noun	KAlI_samayZa
offset_noun	oYPaseta
on-line_noun	yugapaw/lAina-ArUDZa
one-address_noun	eka_pawA
one-chip_noun	eka_patalikA
one-element_noun	eka-avayava
one-for-one_noun	ekEka
one-output_noun	eka_nirgama
open-ended_noun	vivqwAMwa
operand_noun	saMkArya
operation_noun	saMkriyA/pracAlana
operator_noun	pracAlaka/oYparetara/saMkAraka
optimization_noun	iRtamIkaraNa
option_noun	vikalpa
optoelectronics_noun	prakASa_ilektroYnikI
optoisolater_noun	prakASIya_pqWakkAraka
or_noun	aWavA'
output_noun	nirgama
overflow_noun	aXipravAha
overload_noun	awiBAra
overprinting_noun	awimuxraNa
overpunch_noun	awi_CixraNa
owner_noun	svAmI
pacing_noun	paxanicayana
pack_noun	saMkula/gaddI
package_noun	pEkaga/saMkula
packet_noun	pEkata
packing_noun	saMkulana
pad_noun	pEda/niyawamAna_kRINakArI
padding_noun	pEdana
page_noun	pqRTa
pagination_noun	pqRTIkaraNa
paging_noun	pqRTana
panel_noun	pEnala/pattikA
paragraph_noun	pErAgrAPa/pErA
parallelism_noun	yugapawwA
parameter_noun	prAcala
parametron_noun	pErAmetroYna
parse_noun	paxa_vyAKyA
parser_noun	paxa_vyAKyAyiwra
parsing_noun	paxa_paricaya
partitioning_noun	viBAjana
pascal-plus_noun	pAskalaplasa
passband_noun	pAraNabEMdZa
password_noun	pAraNa_Sabxa
patch_noun	yaWecCa_yojaka
peg0count_noun	uxbuXana_saMKyA
pel_noun	ciwra_avayava
percolation_noun	uwpAraNa
perforator_noun	avaCixriwra
peripheral_noun	upAMwIya/upasAXana/sahAyaka_yaMwra
phoneme_noun	svanima
pictorial_noun	ciwramaya/ciwrIya
pipelining_noun	saMpaMkwIyana
pitch_noun	saMprawIka_aMwarAla
pixel_noun	ciwra_avayava
pixelization_noun	ciwra_avayavIkaraNa
place_noun	sWAna
platen_noun	pletana/rohapatata
plex_noun	saMkewana
plotter_noun	AleKiwra
plotting_noun	AleKana
plugboard_noun	plagaborda
pocket_noun	saMcayikA
polling_noun	kramavaraNa
polymorphic_noun	bahurUpI
pop_noun	saMkarRa
port_noun	saMxvAra
positioning_noun	sWiwi_nirXAraNa
postamble_noun	pAxasWa_kUta
postcondition_noun	paSca_avasWA
postedit_noun	paSca_saMpAxana
postmortem_noun	uparAMwa_viSleRaNa
precision_noun	pariSuxXawA/pariSuxXi
precondition_noun	pUrva_prawibaMXa
predicate_noun	nirXAraka/viXeya
preprocessor_noun	pUrvasaMsAXiwra
preset_noun	pUrva_nirXAriwa
presort_noun	CaztAI_pUrva/SAtana_pUrva
prestore_noun	BaMdAraNa_pUrva
printer_noun	muxriwra
prioritize_noun	varIyana
privacy_noun	gopanIyawA
processing_noun	saMsAXana
processor_noun	saMsAXiwra
program_noun	kramAxeSa/progrAma
programatics_noun	kramAxeSikI
programmer_noun	kramAxeSaka/kramAxeSiwra
programming_noun	kramaxeSana/progrAmana
prompt_noun	AhvAna
protocol_noun	saxeSAcAra
proving_noun	pramANana
pseudo-instruction_noun	Caxma_anuxeSa
pseudoclock_noun	Caxma_kAlaxa
pseudocursor_noun	Caxma_prasaMkewaka
pulse_noun	spaMxa
pulser_noun	spaMxaka
punch_noun	CixraNa/Cixriwra
punctuation_noun	virAma_cihnana
push_noun	saMBara
push-down_noun	aXosaMBara
quad_noun	cawuH
quadripuntal_noun	cawuH_CixrI
quadruple_noun	cawuRka
qualifier_noun	viSeRaka
quantification_noun	pramAwrIkaraNa
quantifier_noun	pramAwraka
quantize_noun	kvAntamana
quantizer_noun	kvAntamaka
quartet_noun	cawuRtaya
query_noun	pqcCA
queue_noun	paMkwi
queuing_noun	paMkwiyana
quiesce_noun	akriyaNa
quiescent_noun	niRpaMxa
quinary_noun	paMcAXArI
quintet_noun	paMcawaya
rack_noun	rEka
racking_noun	paMkwiSaH_praxarSa
radix_noun	mUlAMka
range_noun	parisara
raster_noun	rEstara/reKApuMja
re-entrant_noun	punaH_praveSya
reachability_noun	gamyawA
read_noun	paTana
read-only_noun	kevala_paTana
reader_noun	paTiwra
reader-copier_noun	paTiwra_prawilipiwra
reading_noun	paTana/pATyAMka
realm_noun	parikRewra
receiver_noun	aBigrAhI
recompile_noun	punaH_anuBARaNa
recomplementation_noun	punaH_pUrakIkaraNa
reconciliation_noun	samAXAna
reconfiguration_noun	punarvinyAsa
reconstitution_noun	racanA/punargaTana
reconstruction_noun	punargaTana/punarracanA
recurrence_noun	punarAvqwwi
recursion_noun	punarAvarwana
redact_noun	niveSa_saMpAxana
redaction_noun	saMSoXiwa_niveSa_saMskaraNa
redundancy_noun	awirikwawA
reenlargement_noun	punarvarXana
reference_noun	nirxeSa/saMxarBa
refile_noun	punassaMcikAyana
reflectance_noun	parAvarwakawA
reformat_noun	punaH_saMrUpaNa
refresh_noun	punaScaryA/punarjanana
regeneration_noun	punarjanana/punaryojana
register_noun	paMjI
relay_noun	rile/prawisAraNa
release_noun	mocana
reliability_noun	viSvasanIyawA
remote_noun	suxUra
reorder_noun	punarAxeSa
repagination_noun	punaHpqRTIkaraNa
rerun_noun	punarXAva
reset_noun	puna:_AraMBana
resident_noun	smqwivAsI
resolver_noun	viyojaka
restart_noun	puna:_prAraMBa
restore_noun	puna:_sWApana
retrofit_noun	anuyojana
retry_noun	puna:_prayAsa
return_noun	prawigamana
rewrite_noun	punarleKana
ring_noun	valaya
routine_noun	nemakA
routing_noun	anumArgaNa
run_noun	XAva
sampling_noun	prawixarSI/prawicayana
satisfiability_noun	saMwoRaNIyawA
saturation_noun	saMwqpwi/saMwqpwIkaraNa
scalar_noun	axiSa
scaling_noun	sopAnana
scan_noun	kramavIkRaNa
scanner_noun	kravamIkRaka
schema_noun	vivaraNikA
scissoring_noun	karwana
scrambler_noun	asPutaka
scratch_noun	liKamita
screen_noun	prapatta
scroll_noun	pariluMTana
searching_noun	Koja_kriyA
security_noun	surakRA
select_noun	varaNa
selector_noun	variwra
self-dual_noun	svaxvEwa
semantics_noun	arXa_vijFAna
semi-group_noun	sAmi_samUha
semi-ring_noun	sAmivalaya
sense_noun	saMvexana/aBixiSa/BAva
sensor_noun	saMvexiwra
sensor-based_noun	saMvexiwra_AXArI
sentence_noun	vAkya
separator_noun	pqWakkiwra/pqWakkArI
septet_noun	sapwikA
sequence_noun	anukrama
sequencer_noun	anukramaka
sequencing_noun	anukramaNa
sequency_noun	anukramaNa_vqwwi
serial-by-bit_noun	xvayaMkakramI
serial-input-output_noun	kramika_niveSa_nirgama
serial-parallel_noun	kramika-yugapawa
server_noun	parisevaka
servomultiplier_noun	sarvo_guNaka
seven-bit-byte_noun	sAwa_xvayaMka_bAita
sextet_noun	Ratka
shading_noun	CAyAMkana
shannon_noun	SEnana
sharing_noun	sahaBAjana
sheet_noun	parNa
shift_noun	visWApana
shop_noun	kAryaSAlA
sibling_noun	sahoxara
sign_noun	cihna
signal_noun	saMkewa/signala
simscript_noun	simsakripta
simulator_noun	anukArI
sizing_noun	AmApana
skip_noun	pluwi
skipping_noun	pluwi
slice_noun	kawalI
slicer_noun	kawalIyaka
slicing_noun	kawalIyana
slot_noun	KAzcA
smoothing_noun	samakaraNa
smudge_noun	masI_viswaraNa
sniffing_noun	wrutimArjana
snobol_noun	snoboYla
socket_noun	soYketa
software_noun	prakriyA_sAmagrI
solvable_noun	sAXanIya
sorter_noun	SAtiwra
sorting_noun	SAtana
space_noun	rikwi/samaRti/nimaga/AkASa
spline_noun	splAina
splitting_noun	viBAjana
spool_noun	spUla
spooler_noun	spUlaka
spooling_noun	spUlana
squeal_noun	avakaMpa
squealing_noun	avakaMpana
stack_noun	ciwi
stacking_noun	ciwIyana
staging_noun	maMcana
standardization_noun	mAnakIkaraNa
standby_noun	ApAwopayogI
starvation_noun	aprApwi
statement_noun	kaWana
staticize_noun	sWEwikana
stator_noun	stEtara/sWirAMga
status_noun	avasWiwi
stopper_noun	virAmaka
storage_noun	BaMdAraNa
store_noun	BaMdAra
string_noun	rajju/mAlA
strobe_noun	aBicAyI
structure_noun	saMracanA
stub_noun	sWUNa/TUzTa
stylus_noun	SUka
subchannel_noun	upapraNAla
subcommand_noun	upasamAxeSa
subdatabase_noun	upa_AzkadZA_saMcaya
subfield_noun	upakRewra
subgeneration_noun	upajanana
sublist_noun	upasUcI
submatrix_noun	upamEtriksa
subparameter_noun	upaprAcala
subprogram_noun	upakramAxeSa
subroutine_noun	upanemakA
subschema_noun	upavivaraNikA
subscript_noun	pAxAMka/pAxAkRara
substitution_noun	prawisWApana
substring_noun	uparajju
subsystem_noun	upawaMwra
subtask_noun	upakArya
subtractor_noun	vyavakaliwra
subtree_noun	upawaru
suffix_noun	anulagna
suite_noun	sarvAga
sumcheck_noun	yoga_jAzca
summer_noun	saMkaliwra
supergroup_noun	awi_samUha
supervisor_noun	paryavekRaka
suppression_noun	xamana
surjection_noun	AcCAxAna
suspended_noun	nilaMbiwa
swap_noun	gamAgama
swaping_noun	samAgamana
switch_noun	svica
switching_noun	svicana
symbol_noun	prawIka
synch_noun	wulyakAlika
synchronization_noun	wulyakAlana
synchronizer_noun	wulyakAlaka
synchronous_noun	wulyakAlika/wulyakAlI
syndetic_noun	saMxarBaxarSI
synergetic_noun	yuwi_praBAvI
synergic_noun	samanviwa
syntax_noun	vAkya_racanA
t-flipflop_noun	xvimAniwra
tablet_noun	sAraNikA
teleconferencing_noun	xUra_sammelana
telenet_noun	xUra_jAla
teleprinter_noun	xUra_muxriwra
telescreen_noun	presa_grAhI_xUra_prapatta
teletext_noun	xUra_pATyAMSa
terminal_noun	aMwaka/tarminala
terminalequipment_noun	aMwaka_upakaraNa
termination_noun	samApana
testing_noun	parIkRaNa
threading_noun	sUwraNa
timeout_noun	kAla_samApana
track_noun	paWa
transducer_noun	trAMnsadyUsara
transfinite_noun	parimiwAwIwa
translation_noun	anuvAxa
transliteration_noun	lipyaMwaraNa
transmission_noun	pAraxarSI_saMcaraNa
transmitter_noun	preRiwra
transmultiplexer_noun	preRiwra_bahu_saMkewaka
transponder_noun	pArAnukAriwra
trap_noun	prapASa
trapping_noun	prapASana
traversal_noun	paWakramaNa
traverse_noun	mAlA_reKA
tree_noun	waru
trend_noun	upanawi
triad_noun	wraya
trigger_noun	trigara
triplet_noun	wrika
truncate_noun	Cinna
truncation_noun	Cinna
trunk_noun	traMka
tumbling_noun	AluMTana
tuning_noun	samasvaraNa
tymnet_noun	timaneta
type_noun	prakAra
u-format_noun	apariBARiwa_saMrUpa
unblank_noun	alopana/rikwiBaraNa
unbunding_noun	mUlya_pqWakkaraNa
uncol_noun	anakola
unconditionaljump_noun	aprawibaMXiwa_JaMpa
undecidable_noun	anirNeya
undefined_noun	apariBARiwa
undercode_noun	avakUta
underflow_noun	aXa:_pravAha
underpunch_noun	aXa:_Cixra
underrun_noun	aXoXAva
underscore_noun	aXoreKA
uniprocessing_noun	eka_saMsAXana
uniterm_noun	eka_paxI
unlock_noun	viwAlakana
unpacking_noun	visaMkulana
unsolvable_noun	asAXanIya
updating_noun	axyawanIkaraNa
user_noun	upayokwA
validation_noun	mAnyakaraNa
variplotter_noun	parivarwI_AleKiwra/verI_ploYtara
vectoring_noun	saxiSana
verifier_noun	sawyApiwra
videodisk_noun	vidiyo_cakrikA
viewdata_noun	xqSya_AzkadZe
vocabulary_noun	anuxeSAvalI
wafer_noun	varaka
wafering_noun	varakana
wideband_noun	viswqwa_bEMda
window_noun	gavAkRa
windowing_noun	gavAkRana
write_noun	leKana
arbitrary_noun	manamAnA
appied_noun	anuprayukwa
commerce_noun	vANijya
commercial_noun	vANijyika
commercially_noun	vANijyika_rUpa_se
open-minded_noun	vivqwAMwa
perceive_noun	saMvexana
