8_puzzle	eta_pajZala#eta_pajZala#noun#2#RM
a-star_algorithm	e-stAra_kalana_viXi/e-stAra_elgorixama#e-stAra_kalana_viXi/e-stAra_elgorixama#noun#2#RM
a-star_algorithm_algorithm	e-stAra_kalana_viXi/e-stAra_elgorixama#e-stAra_kalana_viXi/e-stAra_elgorixama#noun#3#RM
a_priori_probability	e_prIyorI_probebilitI#e_prIyorI_probebilitI#noun#3#RM
a_star	e_stAra/e-stAra#e_stAra/e-stAra#noun#2#RM
a_star_algorithm	e_stAra_kalana_viXi/e_stAra_elgorixama#e_stAra_kalana_viXi/e_stAra_elgorixama#noun#3#RM
absolute_value	ebsalUta_vElyU#ebsalUta_vElyU#noun#2#RM
abstract_transfer	ebstrEkta_trAMsaPara#ebstrEkta_trAMsaPara#noun#2#RM
action_aider	ekSana_edara#ekSana_edara#noun#2#RM
activation_function	ektIveSana_PaMkSana/ektIveSana_PZaMkSana#ektIveSana_PaMkSana/ektIveSana_PZaMkSana#noun#2#RM
adaptive_algorithm	anukUlI_kalanaviXi/adeptiva_elgorixama#anukUlI_kalanaviXi/adeptiva_elgorixama#noun#2#RM
adjacency_representation	edajeMsI_riprajeMteSana#edajeMsI_riprajeMteSana#noun#2#RM
admissible_function	edamisiba_PaMkSana/edamisibala_PaMkSana/svIkArya_PZaMkSana/Edmisibala_PaMkSana#edamisiba_PaMkSana/edamisibala_PaMkSana/svIkArya_PZaMkSana/Edmisibala_PaMkSana#noun#2#RM
admissible_heuristic	edamisibala_hyUristika#edamisibala_hyUristika#noun#2#RM
admissible_heuristic_function	edamisibala_hyUristika_PaMkSana#edamisibala_hyUristika_PaMkSana#noun#3#RM
admissible_point	edamisibala_poYiMta#edamisibala_poYiMta#noun#2#RM
agenda_driven_search	ejeMdA_drivena_sarca#ejeMdA_drivena_sarca#noun#3#RM
agenda_driven_system	ejeMdA_drivena_sistama#ejeMdA_drivena_sistama#noun#3#RM
agent_based_planning	ejeMta_besda_plAniMga#ejeMta_besda_plAniMga#noun#3#RM
ai_programs	eAI_progrAmsa#eAI_progrAmsa#noun#2#RM
ai_systems	eAI_sistamsa#eAI_sistamsa#noun#2#RM
ai_techniques	eAI_tekniksa#eAI_tekniksa#noun#2#RM
alpha-beta_pruning	alPA-bItA_prUniMga#alPA-bItA_prUniMga#noun#2#RM
alpha_and_beta_cutoff	alPA_Ora_bItA_kataoYPa#alPA_Ora_bItA_kataoYPa#noun#4#RM
alpha_and_beta_cutoffs	alPA_eMda_bItA_kataoYPsa#alPA_eMda_bItA_kataoYPsa#noun#4#RM
alpha_beta_cutoffs	alPA_eMda_bItA_kataoYPsa/alPA_bItA_kataoYPa/alPA_bItA_kataoYPsa#alPA_eMda_bItA_kataoYPsa/alPA_bItA_kataoYPa/alPA_bItA_kataoYPsa#noun#3#RM
alpha_beta_pruning	alPA_bItA_prUniMga#alPA_bItA_prUniMga#noun#3#RM
alpha_cutoff	alPA_kataoYPa#alPA_kataoYPa#noun#2#RM
alpha_cutoffs	alPA_kataoYPsa#alPA_kataoYPsa#noun#2#RM
analog_signal	anurUpa_saMkewa/enAloYga_signala#anurUpa_saMkewa/enAloYga_signala#noun#2#RM
and-or_graphs	eMda-oYra_grAPsa#eMda-oYra_grAPsa#noun#2#RM
and_arc	eMda_Arka#eMda_Arka#noun#2#RM
and_or_graph	eMda_oYra_grAPa#eMda_oYra_grAPa#noun#3#RM
and_or_graphs	eMda_oYra_grAPsa#eMda_oYra_grAPsa#noun#3#RM
annealing_process	enIliMna_prakriyA#enIliMna_prakriyA#noun#2#RM
annealing_schedule	enIliMga_SedyUla#enIliMga_SedyUla#noun#2#RM
ant_colony_optimization	EMta_koYlonI_oYptimAijZeSana#EMta_koYlonI_oYptimAijZeSana#noun#3#RM
artificial_intelligence	kqwrima_buxXimawwA/ArtiPiSala_iMtelijeMsa/ArtiPIsiyala_iMtelijeMsa#kqwrima_buxXimawwA/ArtiPiSala_iMtelijeMsa/ArtiPIsiyala_iMtelijeMsa#noun#2#RM
artificial_intelligence_program	kqwrima_buxXimawwA_progrAma/ArtiPiSala_iMtelijeMsa_progrAma#kqwrima_buxXimawwA_progrAma/ArtiPiSala_iMtelijeMsa_progrAma#noun#3#RM
artificial_neural_networks	ArtiPiSiyala_nyUrala_netavarksa#ArtiPiSiyala_nyUrala_netavarksa#noun#3#RM
artificial_neuron	ArtiPiSiyala/ArtiPiSiyala_nyUroYna#ArtiPiSiyala/ArtiPiSiyala_nyUroYna#noun#2#RM
artificial_neurons	ArtiPiSiyala_nyUroYnsa#ArtiPiSiyala_nyUroYnsa#noun#2#RM
assignment_problem	asAinameMta_problama#asAinameMta_problama#noun#2#RM
associative_search	asosetiva_sarca/jodZane_vAlI_Koja#asosetiva_sarca/jodZane_vAlI_Koja#noun#2#RM
attack_sequence	atEka_sIkvansa#atEka_sIkvansa#noun#2#RM
auto_navigator_problem	oYto_nevigetara_samasyA/oYto_nevigetara_prAblama#oYto_nevigetara_samasyA/oYto_nevigetara_prAblama#noun#3#RM
b_star	bI_stAra#bI_stAra#noun#2#RM
b_star_algorithm	bI_stAra_elgorixama#bI_stAra_elgorixama#noun#3#RM
back_propagation	bEka_proYpageSana/vApasa_saMcaraNa#bEka_proYpageSana/vApasa_saMcaraNa#noun#2#RM
back_propagation_algorithm	bEka_proYpageSana_elgorixama/vApasa_saMcaraNa_kalana_viXi#bEka_proYpageSana_elgorixama/vApasa_saMcaraNa_kalana_viXi#noun#3#RM
back_propagation_network	vApasa_saMcaraNa_netavarka/bEka_proYpageSana_netavarka#vApasa_saMcaraNa_netavarka/bEka_proYpageSana_netavarka#noun#3#RM
back_propagation_neural_network	bEka_proYpageSana_nyUrala_netavarka/vApasa_saMcaraNa_waMwrikA_netavarka#bEka_proYpageSana_nyUrala_netavarka/vApasa_saMcaraNa_waMwrikA_netavarka#noun#4#RM
back_up_value	bEka_apa_vElyU#bEka_apa_vElyU#noun#3#RM
backward_chaining	bEkavarda_ceniMga#bEkavarda_ceniMga#noun#2#RM
backward_chaining_mechanism	bEkavarda_cEniMga_mekEnijZma#bEkavarda_cEniMga_mekEnijZma#noun#3#RM
backward_chaining_process	bEkavarda_ceniMga_prosesa#bEkavarda_ceniMga_prosesa#noun#3#RM
backward_planning	bEkavarda_plAniMga#bEkavarda_plAniMga#noun#2#RM
backward_reasoning	bEkavarda_rIjZaniMga#bEkavarda_rIjZaniMga#noun#2#RM
backward_reasoning_process	bEkavarda_rIjZaniMga_proYsesa#bEkavarda_rIjZaniMga_proYsesa#noun#3#RM
backward_state_space_planning	bEkavarda_steta_spesa_plAniMga#bEkavarda_steta_spesa_plAniMga#noun#4#RM
basic_building_blocks	besika_bildiMga_bloYksa#besika_bildiMga_bloYksa#noun#3#RM
bays_formula	besa_PArmulA#besa_PArmulA#noun#2#RM
beam_search	bIma_sarca#bIma_sarca#noun#2#RM
best_first_search	besta_Parsta_sarca#besta_Parsta_sarca#noun#3#RM
beta_cutoff	bItA_kataoYPa#bItA_kataoYPa#noun#2#RM
binary_neuron	bAinarI_nyUroYna#bAinarI_nyUroYna#noun#2#RM
binary_tree	bAinarI_trI#bAinarI_trI#noun#2#RM
binary_value	bAinarI_vElyU#bAinarI_vElyU#noun#2#RM
black_box	blEka_boYksa#blEka_boYksa#noun#2#RM
blind_search	nirmUla_Koja/blAiMda_sarca#nirmUla_Koja/blAiMda_sarca#noun#2#RM
blind_search_methods	nirmUla_Koja_viXiyoM/blAiMda_sarca_meWadsa#nirmUla_Koja_viXiyoM/blAiMda_sarca_meWadsa#noun#3#RM
blocks_world_problem	bloYksa_varlda_problama#bloYksa_varlda_problama#noun#3#RM
book_move	buka_mUva#buka_mUva#noun#2#RM
book_moves	buka_mUvaja#buka_mUvaja#noun#2#RM
branch_and_bound	brAMca_eMda_bAuMda/brAMca_Ora_bAuMda#brAMca_eMda_bAuMda/brAMca_Ora_bAuMda#noun#3#RM
branch_and_bound_search	brAMca_eMda_bAuMda_sarca#brAMca_eMda_bAuMda_sarca#noun#4#RM
branch_in_bound	brAMca_ina_bAuMda#brAMca_ina_bAuMda#noun#3#RM
branching_factor	praSAKI_Gataka/brEMciMga_PEktara/brAMciMga_PEktara#praSAKI_Gataka/brEMciMga_PEktara/brAMciMga_PEktara#noun#2#RM
breadth-first_search	bredaWa-Parsta_sarca#bredaWa-Parsta_sarca#noun#2#RM
breadth_first	bredWa_Parsta#bredWa_Parsta#noun#2#RM
breadth_first_search	bredWa_Parsta_sarca#bredWa_Parsta_sarca#noun#3#RM
breadth_first_search_methods	bredWa_Parsta_sarca_meWadsa#bredWa_Parsta_sarca_meWadsa#noun#4#RM
building_entities	bildiMga_eMtitIja#bildiMga_eMtitIja#noun#2#RM
calling_node	koYliMga_noda#koYliMga_noda#noun#2#RM
candidate_structures	kEMdideta_saMracanAez/kEMdideta_saMracanAoM#kEMdideta_saMracanAez/kEMdideta_saMracanAoM#noun#2#RM
card_playing_program	kArda_pleIMga_progrAma#kArda_pleIMga_progrAma#noun#3#RM
cascading_effect	kEskediMga_iPekta#kEskediMga_iPekta#noun#2#RM
case_based_planning	mAmalA_AXAriwa_plAniMga/kesa_besda_plAniMga#mAmalA_AXAriwa_plAniMga/kesa_besda_plAniMga#noun#3#RM
case_based_reasoning	mAmalA_AXAriwa_warka/kesa_besda_rIjZaniMga#mAmalA_AXAriwa_warka/kesa_besda_rIjZaniMga#noun#3#RM
causal_relationship	koYjZala_rileSanSipa#koYjZala_rileSanSipa#noun#2#RM
cause_effect_relationship	koYjZa_iPekta_rileSanSipa#koYjZa_iPekta_rileSanSipa#noun#3#RM
certainty_factor	sartentI_PEktara#sartentI_PEktara#noun#2#RM
character_recognition	akRara_pahacAna/kEriktara_rekagniSana#akRara_pahacAna/kEriktara_rekagniSana#noun#2#RM
character_recognition_system	kErektara_rekagniSana_sistama#kErektara_rekagniSana_sistama#noun#3#RM
checkers_game	cekarsa_gema#cekarsa_gema#noun#2#RM
checkers_program	cekarsa_progrAma#cekarsa_progrAma#noun#2#RM
chemical_compound	yOgika_paxArWa/kemikala_kaMpAuMda#yOgika_paxArWa/kemikala_kaMpAuMda#noun#2#RM
chess_player_program	cesa_pleyara_progrAma#cesa_pleyara_progrAma#noun#3#RM
chess_playing_algorithm	cesa_pleIMga_elgorixama#cesa_pleIMga_elgorixama#noun#3#RM
chess_playing_program	cesa_pleIMga_progrAma#cesa_pleIMga_progrAma#noun#3#RM
clausal_form	kloYjZala_PoYrma#kloYjZala_PoYrma#noun#2#RM
client_node	klAyanta_noda#klAyanta_noda#noun#2#RM
combination_and_permutation	saMcaya_Ora_kramacaya/koYmbineSana_eMda_paramuteSana#saMcaya_Ora_kramacaya/koYmbineSana_eMda_paramuteSana#noun#3#RM
combinations_and_permutations	saMcaya_Ora_kramacaya/koYmbineSana_eMda_paramuteSana/koYmbineSana_Ora_paramuteSana#saMcaya_Ora_kramacaya/koYmbineSana_eMda_paramuteSana/koYmbineSana_Ora_paramuteSana#noun#3#RM
combinatorial_explosion	koYmbInetoriyala_ekspalojZana/saMcayavinyAsa_visPota/koYmbinetoriyala_eksaploSana#koYmbInetoriyala_ekspalojZana/saMcayavinyAsa_visPota/koYmbinetoriyala_eksaploSana#noun#2#RM
combinatorial_explosion_problem	koYmbInetoriyala_eksaplojana_problama#koYmbInetoriyala_eksaplojana_problama#noun#3#RM
complete_information	pUrI_jAnakArI#pUrI_jAnakArI#noun#2#RM
complete_network	saMpUrNa_netavarka/kamplIta_netavarka#saMpUrNa_netavarka/kamplIta_netavarka#noun#2#RM
complimentary_literal	samapUraka_SAbxika/koYmplimeMtarI_litarala#samapUraka_SAbxika/koYmplimeMtarI_litarala#noun#2#RM
composite_structure	yOgika_saMracanA/kampojita_strakcara#yOgika_saMracanA/kampojita_strakcara#noun#2#RM
computational_biology_problem	kampyUteSanala_bAyoloYjI_proYblama#kampyUteSanala_bAyoloYjI_proYblama#noun#3#RM
computer_address_space	kampyUtara_Edresa_spesa#kampyUtara_Edresa_spesa#noun#3#RM
computer_domain	kaMpyUtara_domena#kaMpyUtara_domena#noun#2#RM
computer_neuron	kaMpyUtara_nyUroYna#kaMpyUtara_nyUroYna#noun#2#RM
computer_processor	kaMpyUtara_prosesara#kaMpyUtara_prosesara#noun#2#RM
computer_processors	kaMpyUtara_prosesarsa#kaMpyUtara_prosesarsa#noun#2#RM
computer_program	kaMpyUtara_progrAma#kaMpyUtara_progrAma#noun#2#RM
computer_programs	kaMpyUtara_progrAma/kaMpyUtara_progrAmsa#kaMpyUtara_progrAma/kaMpyUtara_progrAmsa#noun#2#RM
computer_science	kaMpyUtara_vijFAna/kaMpyUtara_sAinsa#kaMpyUtara_vijFAna/kaMpyUtara_sAinsa#noun#2#RM
computer_scientist	saMgaNaka_vEjFAnika/kaMpyUtara_sAiMtista#saMgaNaka_vEjFAnika/kaMpyUtara_sAiMtista#noun#2#RM
computer_scientists	kaMpyUtara_sAiMtista#kaMpyUtara_sAiMtista#noun#2#RM
computer_systems	saMgaNaka_waMwra/kaMpyUtara_sistama#saMgaNaka_waMwra/kaMpyUtara_sistama#noun#2#RM
computing_power	kaMpyUtiMga_poYvara#kaMpyUtiMga_poYvara#noun#2#RM
conceptual_categories	kaMsepcyula_kEtegarIja#kaMsepcyula_kEtegarIja#noun#2#RM
conceptual_dependency	kaMsepcyula_dipeMdaMsI/vEcArika_nirBarawA#kaMsepcyula_dipeMdaMsI/vEcArika_nirBarawA#noun#2#RM
conceptual_entity	kaMsepcyula_eMtitI#kaMsepcyula_eMtitI#noun#2#RM
conceptual_role	kaMsepcyula_rola#kaMsepcyula_rola#noun#2#RM
conceptual_roles	kaMsepcyula_rolsa#kaMsepcyula_rolsa#noun#2#RM
conceptual_rules	kaMsepcyula_rUlsa#kaMsepcyula_rUlsa#noun#2#RM
conceptual_tense	kaMsepcyula_teMsa#kaMsepcyula_teMsa#noun#2#RM
conceptual_tenses	kaMsepcyula_teMsesa#kaMsepcyula_teMsesa#noun#2#RM
constant_value	sWira_mAna/koYnstenta_vElyU#sWira_mAna/koYnstenta_vElyU#noun#2#RM
constraint_satisfaction	vyavaroXa_saMwuRti/kansatreMta_sEtisaPEkSana#vyavaroXa_saMwuRti/kansatreMta_sEtisaPEkSana#noun#2#RM
constructive_search	racanAwmaka_Koja/kaMstraktiva_sarca#racanAwmaka_Koja/kaMstraktiva_sarca#noun#2#RM
constructive_search_methods	racanAwmaka_Koja_viXiyAz/kaMstraktiva_sarca_meWadsa#racanAwmaka_Koja_viXiyAz/kaMstraktiva_sarca_meWadsa#noun#3#RM
conventional_depth_first_search	kanveMSanala_depWa_Parsta_sarca#kanveMSanala_depWa_Parsta_sarca#noun#4#RM
credit_assignment_problem	kredita_asAinameMta_proYblama#kredita_asAinameMta_proYblama#noun#3#RM
cumulative_value	saMcayI_mAna/kyUmUletiva_vElyU#saMcayI_mAna/kyUmUletiva_vElyU#noun#2#RM
current_goal	kareMta_gola#kareMta_gola#noun#2#RM
current_node	kareMta_noda#kareMta_noda#noun#2#RM
current_packet	kareMta_pEketa#kareMta_pEketa#noun#2#RM
current_percept	kareMta_parasepta#kareMta_parasepta#noun#2#RM
current_state	kareMta_steta#kareMta_steta#noun#2#RM
cut-off_value	kata-oYPa_velyU#kata-oYPa_velyU#noun#2#RM
cut_off_value	kata_oYPa_vElyU#kata_oYPa_vElyU#noun#3#RM
cyclic_crossover	cakrIya_kroYsaovara/sAyaklika_kroYsaovara#cakrIya_kroYsaovara/sAyaklika_kroYsaovara#noun#2#RM
data_loss	detA_loYsa#detA_loYsa#noun#2#RM
data_structure	detA_strakcara#detA_strakcara#noun#2#RM
database_server_problem	detAbesa_sarvara_proYblama#detAbesa_sarvara_proYblama#noun#3#RM
database_servers	detAbesa_sarvarsa#detAbesa_sarvarsa#noun#2#RM
decision_surface	nirNaya_sawaha/disiSana_saraPesa#nirNaya_sawaha/disiSana_saraPesa#noun#2#RM
decision_surfaces	nirNaya_sawahoM/disiSana_saraPesesa#nirNaya_sawahoM/disiSana_saraPesesa#noun#2#RM
deep_blue	dIpa_blU#dIpa_blU#noun#2#RM
deep_learning	dIpa_larniMga#dIpa_larniMga#noun#2#RM
deep_thought	dIpa_WoYta#dIpa_WoYta#noun#2#RM
deep_thought_two	dIpa_WoYta_tU#dIpa_WoYta_tU#noun#3#RM
default_assumption	diPZoYlta_asampSana#diPZoYlta_asampSana#noun#2#RM
default_assumptions	diPZoYlta_asampSansa#diPZoYlta_asampSansa#noun#2#RM
degree_of_freedom	digrI_oYPa_Pridama/digrI_oYPa_PrIdama#digrI_oYPa_Pridama/digrI_oYPa_PrIdama#noun#3#RM
delta_one	deltA_vana#deltA_vana#noun#2#RM
delta_two	deltA_tU#deltA_tU#noun#2#RM
denial_of_service_attack	dinAyala_oYPa_sarvisa_atEka#dinAyala_oYPa_sarvisa_atEka#noun#4#RM
dense_neighborhood	deMsa_nebarahuda#deMsa_nebarahuda#noun#2#RM
dense_neighborhood_function	densa_nebarahuda_PaMkSana/deMsa_nebarahuda_PaMkSana#densa_nebarahuda_PaMkSana/deMsa_nebarahuda_PaMkSana#noun#3#RM
dense_neighbourhood	densa_nebarahuda#densa_nebarahuda#noun#2#RM
dense_neighbourhood_function	densa_nebarahuda_PaMkSana#densa_nebarahuda_PaMkSana#noun#3#RM
dependency_driven_backtracking	nirBarawA_saMcAliwa_bEkatrEkiMga/dipeMdaMsI_drivana_bEkatrEkiMga#nirBarawA_saMcAliwa_bEkatrEkiMga/dipeMdaMsI_drivana_bEkatrEkiMga#noun#3#RM
dependency_driven_reasoning	nirBarawA_saMcAliwa_warka/dipeMdaMsI_drivana_rIjZaniMga#nirBarawA_saMcAliwa_warka/dipeMdaMsI_drivana_rIjZaniMga#noun#3#RM
depth-first_search	depWa_Parsta_sarca/depWa-Parsta_sarca#depWa_Parsta_sarca/depWa-Parsta_sarca#noun#2#RM
depth_bound	depWa_bAuMda#depWa_bAuMda#noun#2#RM
depth_bound_depth-first_search	depWa_bAuMda_depWa_Parsta_sarca#depWa_bAuMda_depWa_Parsta_sarca#noun#4#RM
depth_bound_search	depWa_bAuMda_sarca#depWa_bAuMda_sarca#noun#3#RM
depth_first_depth_limited	depWa_Parsta_depWa_limiteda#depWa_Parsta_depWa_limiteda#noun#4#RM
depth_first_iterative_deepening	depWa_Parsta_itaretiva_dIpaniMga#depWa_Parsta_itaretiva_dIpaniMga#noun#4#RM
depth_first_iterative_deepening_search	depWa_Parsta_itaretiva_dIpaniMga_sarca#depWa_Parsta_itaretiva_dIpaniMga_sarca#noun#5#RM
depth_first_search	depWa_Parsta_sarca#depWa_Parsta_sarca#noun#3#RM
depth_limited	depWa_limiteda#depWa_limiteda#noun#2#RM
depth_value	depWa_vElyU#depWa_vElyU#noun#2#RM
detailed_planning	ditelda_plAniMga#ditelda_plAniMga#noun#2#RM
direction_relationship	direkSana_rileSanSipa#direkSana_rileSanSipa#noun#2#RM
discrete_function	diskrIta_PaMkSana#diskrIta_PaMkSana#noun#2#RM
distance_matrix	xUrI_AvyUha/distansa_mEtriksa#xUrI_AvyUha/distansa_mEtriksa#noun#2#RM
distributed_storage	viwariwa_saMcayana/distribyUteda_storeja#viwariwa_saMcayana/distribyUteda_storeja#noun#2#RM
domain_knowledge	domena_jFAna/domena_noYleja#domena_jFAna/domena_noYleja#noun#2#RM
draught_game	drAPta_gema#drAPta_gema#noun#2#RM
dummy_variable	ABAsI_cara/damI_variebala#ABAsI_cara/damI_variebala#noun#2#RM
effect_link	iPekta#iPekta#noun#2#RM
eight_puzzle	eita_pajZala/eta_pajZala#eita_pajZala/eta_pajZala#noun#2#RM
electrochemical_reactions	vixyuwa_rAsAyanika_prawikriyAoM/ilektrokemikala_riektAnsa#vixyuwa_rAsAyanika_prawikriyAoM/ilektrokemikala_riektAnsa#noun#2#RM
electrochemical_signal	vixyuwa_rAsAyanika_saMkewa/ilektrokemikala_signala#vixyuwa_rAsAyanika_saMkewa/ilektrokemikala_signala#noun#2#RM
electromagnetic_waves	vixyuwa_cumbakIya_waraMgoM/ilektromEgnetAika_vevajZa#vixyuwa_cumbakIya_waraMgoM/ilektromEgnetAika_vevajZa#noun#2#RM
end_state	eMda_steta#eMda_steta#noun#2#RM
end_states	eMda_stetsa#eMda_stetsa#noun#2#RM
entity_relationship_diagram	eMtitI_rileSanaSipa_dAyagrAma#eMtitI_rileSanaSipa_dAyagrAma#noun#3#RM
epoch_value	Ipoka_vElyU#Ipoka_vElyU#noun#2#RM
existential_and_universal_quantifier	aswiwvagawa_Ora_sArvaBOmika_parimANaka/eksistenSiyala_eMda_yUnivarsala_kvAMtiPAyara#aswiwvagawa_Ora_sArvaBOmika_parimANaka/eksistenSiyala_eMda_yUnivarsala_kvAMtiPAyara#noun#4#RM
existential_quantifier	aswiwvagawa_parimANaka/eksistenSiyala_kvAMtiPAyara#aswiwvagawa_parimANaka/eksistenSiyala_kvAMtiPAyara#noun#2#RM
expert_system	viSeRajFa_praNAlI/eksaparta_sistama#viSeRajFa_praNAlI/eksaparta_sistama#noun#2#RM
expert_systems	eksaparta_sistamsa#eksaparta_sistamsa#noun#2#RM
exploration_process	anveRaNa_prakriyA/eksaploreSana_prosesa#anveRaNa_prakriyA/eksaploreSana_prosesa#noun#2#RM
explored_node	eksaplorda_noda#eksaplorda_noda#noun#2#RM
explored_nodes	anaeksaplorada_nodsa/eksaplorada_nodsa/eksaplorda_nodsa#anaeksaplorada_nodsa/eksaplorada_nodsa/eksaplorda_nodsa#noun#2#RM
face_detection_systems	Pesa_ditekSanasistamsa#Pesa_ditekSanasistamsa#noun#3#RM
fault_tolerance	PAlta_tolareMsa#PAlta_tolareMsa#noun#2#RM
fault_tolerant	PAlta_toYlareMta/PAlta_tolereMta#PAlta_toYlareMta/PAlta_tolereMta#noun#2#RM
feed_forward	PIda_PoYrvarda#PIda_PoYrvarda#noun#2#RM
feed_forward_network	PIda_PoYrvarda_netavarka#PIda_PoYrvarda_netavarka#noun#3#RM
felder-silverman_model	Peldara-silvaramEna_moYdala#Peldara-silvaramEna_moYdala#noun#2#RM
final_node	PAinala_noda#PAinala_noda#noun#2#RM
final_state	aMwima_avasWA/PAinala_steta/AraMBika_avasWA#aMwima_avasWA/PAinala_steta/AraMBika_avasWA#noun#2#RM
final_states	aMwima_avasWAez/PAinala_stetsa/aMwima_avasWAoM#aMwima_avasWAez/PAinala_stetsa/aMwima_avasWAoM#noun#2#RM
fingerprint_recognition	PiMgarapriMta_pahacAna/PiMgarapriMta_rikagniSana#PiMgarapriMta_pahacAna/PiMgarapriMta_rikagniSana#noun#2#RM
first_order_predicate_logic	praWama_krama_nirXAraka_warka/Parsta_oYrdara_predIketa_loYjika#praWama_krama_nirXAraka_warka/Parsta_oYrdara_predIketa_loYjika#noun#4#RM
fitness_function	Pitanesa_PaMkSana#Pitanesa_PaMkSana#noun#2#RM
fitness_values	Pitanesa_mAna/Pitanesa_vElyUjZa/Pitanesa_velyUja#Pitanesa_mAna/Pitanesa_vElyUjZa/Pitanesa_velyUja#noun#2#RM
formal_logic	rUpAwmaka_warka/PoYrmala_loYjika#rUpAwmaka_warka/PoYrmala_loYjika#noun#2#RM
forward_planning	PoYrvarda_plAniMga#PoYrvarda_plAniMga#noun#2#RM
forward_reasoning	PoYrvarda_rIjZaniMga#PoYrvarda_rIjZaniMga#noun#2#RM
forward_reasoning_process	PoYvarda_rIjZaniMga_proYsesa#PoYvarda_rIjZaniMga_proYsesa#noun#3#RM
forward_state_space_planning	PoYrvarda_steta_spesa_plAniMga#PoYrvarda_steta_spesa_plAniMga#noun#4#RM
frame_system	Prema_sistama#Prema_sistama#noun#2#RM
frame_work	Prema_varka#Prema_varka#noun#2#RM
fuzzy_boundary	PajI_bAundrI#PajI_bAundrI#noun#2#RM
fuzzy_logic	PajI_loYjika#PajI_loYjika#noun#2#RM
fuzzy_logic_system	PajI_loYjika_sistama#PajI_loYjika_sistama#noun#3#RM
fuzzy_logic_values	PajI_loYjika_vElyUja#PajI_loYjika_vElyUja#noun#3#RM
fuzzy_reasoning	PajI_rIjZaniMga#PajI_rIjZaniMga#noun#2#RM
fuzzy_set	PajI_seta#PajI_seta#noun#2#RM
fuzzy_sets	PajI_setsa#PajI_setsa#noun#2#RM
g_plus_h	jI_plasa_eca#jI_plasa_eca#noun#3#RM
g_plus_h_dash	jI_plasa_eca_dESa#jI_plasa_eca_dESa#noun#4#RM
g_plus_h_dash_value	jI_plasa_eca_dESa_vElyU#jI_plasa_eca_dESa_vElyU#noun#5#RM
g_plus_h_value	jI_plasa_eca_vElyU#jI_plasa_eca_vElyU#noun#4#RM
g_plus_s_h_dash	jI_plasa_esa_eca_dESa#jI_plasa_esa_eca_dESa#noun#5#RM
game_playing	Kela_KelanA/gema_pleIMga/Kela_Kelane#Kela_KelanA/gema_pleIMga/Kela_Kelane#noun#2#RM
game_playing_algorithms	Kela_Kelane_kI_kalana_viXi/gema_pleIMga_elgorixamoM/Kela_Kelane_kI_kalana_viXiyoM/gema_pleIMga_elgorixamsa#Kela_Kelane_kI_kalana_viXi/gema_pleIMga_elgorixamoM/Kela_Kelane_kI_kalana_viXiyoM/gema_pleIMga_elgorixamsa#noun#3#RM
game_playing_program	gema_pleIMga_progrAma#gema_pleIMga_progrAma#noun#3#RM
game_playing_programs	gema_pleIMga_progrAmsa#gema_pleIMga_progrAmsa#noun#3#RM
game_tree	gema_trI#gema_trI#noun#2#RM
generate_and_test	janareta_eMda_testa#janareta_eMda_testa#noun#3#RM
genetic_algorithm	jenetika_elgoriWama/jenetika_elgorixama#jenetika_elgoriWama/jenetika_elgorixama#noun#2#RM
genetic_algorithms	anuvAMSika_kalana_viXi/jenetika_elgorixama/anuvAMSika_kalanaviXiyoM/jenetika_elgorixamsa/jenetika_elgoriWamsa#anuvAMSika_kalana_viXi/jenetika_elgorixama/anuvAMSika_kalanaviXiyoM/jenetika_elgorixamsa/jenetika_elgoriWamsa#noun#2#RM
genetic_map	AnuvaMSika_nakSA/jenetika_mEpa#AnuvaMSika_nakSA/jenetika_mEpa#noun#2#RM
geometric_mean	jyAmiwIya_mAXyaka/jiometrika_mIna#jyAmiwIya_mAXyaka/jiometrika_mIna#noun#2#RM
global_heuristic	globala_hyUristika#globala_hyUristika#noun#2#RM
global_heuristic_function	globala_hyUristika_PaMkSana#globala_hyUristika_PaMkSana#noun#3#RM
goal_directed_reasoning	lakRya_nirxeSiwa_warka/gola_dAyarekteda_rIjZaniMga#lakRya_nirxeSiwa_warka/gola_dAyarekteda_rIjZaniMga#noun#3#RM
goal_driven_or_expectancy_driven_reasoning	gola_drivana_ora_ekpektansI_drivana_rIjaniMga#gola_drivana_ora_ekpektansI_drivana_rIjaniMga#noun#6#RM
goal_node	gola_noda/lakRya_noda#gola_noda/lakRya_noda#noun#2#RM
goal_stack_planning	gola_stEka_plAniMga#gola_stEka_plAniMga#noun#3#RM
goal_state	gola_steta/lakRiwa_avasWA#gola_steta/lakRiwa_avasWA#noun#2#RM
graph_traversal_algorithms	grAPa_trEvarsala_elgorixama#grAPa_trEvarsala_elgorixama#noun#3#RM
green_nodes	grIna_nodsa#grIna_nodsa#noun#2#RM
guided_search	nirxeSiwa_Koja_viXi/gAideda_sarca#nirxeSiwa_Koja_viXi/gAideda_sarca#noun#2#RM
guided_search_method	nirxeSiwa_Koja_viXi/gAideda_sarca_meWada#nirxeSiwa_Koja_viXi/gAideda_sarca_meWada#noun#3#RM
guided_search_methods	nirxeSiwa_Koja_viXi/gAideda_sarca_meWadsa/nirxeSiwa_Koja_viXiyAz/gAidida_sarca_mEWadsa/nirxeSiwa_Koja_viXiyoM#nirxeSiwa_Koja_viXi/gAideda_sarca_meWadsa/nirxeSiwa_Koja_viXiyAz/gAidida_sarca_mEWadsa/nirxeSiwa_Koja_viXiyoM#noun#3#RM
h_dash	H_dESa#H_dESa#noun#2#RM
h_dash_h_value	eca_dESa_eca_vElyU#eca_dESa_eca_vElyU#noun#4#RM
h_dash_root_node	eca_dESa_rUta_noda#eca_dESa_rUta_noda#noun#4#RM
h_dash_value	eca_dESa_vElyU#eca_dESa_vElyU#noun#3#RM
handwritten_case_recognition	haswaliKiwa_pahacAna_mAmaloM/hEMdaritana_kesa_rikagniSana#haswaliKiwa_pahacAna_mAmaloM/hEMdaritana_kesa_rikagniSana#noun#3#RM
hard_coding	hArda_kodiMga#hArda_kodiMga#noun#2#RM
hard_constraint	soYPta_kaMstreMnta/hArda_kaMstreMnta#soYPta_kaMstreMnta/hArda_kaMstreMnta#noun#2#RM
hard_constraints	hArda_kaMstreMntsa#hArda_kaMstreMntsa#noun#2#RM
heuristic_crossover	heyuristika_kroYsaovara#heyuristika_kroYsaovara#noun#2#RM
heuristic_function	hyuristika_PaMkSana/hyuristika_PZaMkSana/hyUristika_PaMkSana/hyUristikaPaMkSana#hyuristika_PaMkSana/hyuristika_PZaMkSana/hyUristika_PaMkSana/hyUristikaPaMkSana#noun#2#RM
heuristic_functions	hyUristika_PaMkSansa#hyUristika_PaMkSansa#noun#2#RM
heuristic_search	hyUristika_sarca#hyUristika_sarca#noun#2#RM
heuristic_search_method	hyUristika_sarca_meWada#hyUristika_sarca_meWada#noun#3#RM
heuristic_search_methods	hyUristika_sarca_meWada/hyUristika_sarca_meWadsa#hyUristika_sarca_meWada/hyUristika_sarca_meWadsa#noun#3#RM
heuristic_search_process	hyUristika_sarca_prosesa#hyUristika_sarca_prosesa#noun#3#RM
heuristic_value	hyUristika_mAna/hyUristika_vElyU/hyUristika_mUlya/hyUristika_velyU#hyUristika_mAna/hyUristika_vElyU/hyUristika_mUlya/hyUristika_velyU#noun#2#RM
hidden_layer	CipI_parawa/hidana_leyara#CipI_parawa/hidana_leyara#noun#2#RM
hidden_layer_unit	CipI_parawa_ikAI/hidana_leyara_yUnita#CipI_parawa_ikAI/hidana_leyara_yUnita#noun#3#RM
hidden_markov_model	hidana_mArkova_moYdala#hidana_mArkova_moYdala#noun#3#RM
hidden_output_unit	CipI_Autaputa_ikAiyoM/hidana_Autaputa_yUnita#CipI_Autaputa_ikAiyoM/hidana_Autaputa_yUnita#noun#3#RM
hidden_unit	CipI_ikAiyAz/hidana_yUnita/CipI_ikAiyoM/hidana_yUnitsa/CipI_ikAI/CipI_parawa#CipI_ikAiyAz/hidana_yUnita/CipI_ikAiyoM/hidana_yUnitsa/CipI_ikAI/CipI_parawa#noun#2#RM
hidden_units	CipI_ikAiyoM/hidana_yUnitsa/CipI_ikAIyAz/CipI_huI_ikAiyAz/CipI_huI_ikAiyoM#CipI_ikAiyoM/hidana_yUnitsa/CipI_ikAIyAz/CipI_huI_ikAiyAz/CipI_huI_ikAiyoM#noun#2#RM
hierarchical_generate_and_test	hAyarkiyala_janareta_eMda_testa#hAyarkiyala_janareta_eMda_testa#noun#4#RM
hill_climbing	stIpesta_eseMta_hila_klAimbiMga/hila_klAimbiMga#stIpesta_eseMta_hila_klAimbiMga/hila_klAimbiMga#noun#2#RM
home_state	homa_steta#homa_steta#noun#2#RM
hopfield_network	hoYpaPIlda_netavarka/hoYpaPIlda_netavarksa#hoYpaPIlda_netavarka/hoYpaPIlda_netavarksa#noun#2#RM
hopfield_networks	hoYpaPIlda_netavarksa#hoYpaPIlda_netavarksa#noun#2#RM
horizon_effect	kRiwija_praBAva/horAjZana_iPekta#kRiwija_praBAva/horAjZana_iPekta#noun#2#RM
ids_agents	AIdIesa_ejeMtoM#AIdIesa_ejeMtoM#noun#2#RM
image_processing	imeja_proYsesiMga#imeja_proYsesiMga#noun#2#RM
incomplete_information	aXUrI_jAnakArI/inkamplIta_inParmeSana#aXUrI_jAnakArI/inkamplIta_inParmeSana#noun#2#RM
inference_engine	inParansa_injina#inParansa_injina#noun#2#RM
information_storage	sUcanA_saMcayana/inPoYrameSana_storeja#sUcanA_saMcayana/inPoYrameSana_storeja#noun#2#RM
initial_node	AraMBika_noda/iniSala_noda#AraMBika_noda/iniSala_noda#noun#2#RM
initial_state	AraMBika_avasWA/iniSala_steta/iniSiyala_steta#AraMBika_avasWA/iniSala_steta/iniSiyala_steta#noun#2#RM
initial_states	AraMBika_avasWAez/iniSala_stetsa/AraMBika_avasWAoM#AraMBika_avasWAez/iniSala_stetsa/AraMBika_avasWAoM#noun#2#RM
input_unit	inaputa_ikAiyoM/inaputa_yUnita/inaputa_ikAI#inaputa_ikAiyoM/inaputa_yUnita/inaputa_ikAI#noun#2#RM
input_units	inaputa_ikAiyAz/inaputa_yUnita/inaputa_ikAiyoM/inaputsa_yUnita#inaputa_ikAiyAz/inaputa_yUnita/inaputa_ikAiyoM/inaputsa_yUnita#noun#2#RM
input_values	inaputa_vElyUjZa#inaputa_vElyUjZa#noun#2#RM
input_yUnita	inaputa_ikAI#inaputa_ikAI#noun#2#RM
instance_of_relationship	iMsteMsa_oYPa_rileSanSipa#iMsteMsa_oYPa_rileSanSipa#noun#3#RM
intelligent_program	iMtelIjeMta_progrAma#iMtelIjeMta_progrAma#noun#2#RM
intelligent_programs	iMtelIjeMta_progrAmsa#iMtelIjeMta_progrAmsa#noun#2#RM
intersection_search	prawicCexana_Koja/intarsekSana_sarca#prawicCexana_Koja/intarsekSana_sarca#noun#2#RM
intrusion_detection_agent	inatrujZana_ditekSana_ejeMta/inatruSana_ditekSana_ejeMta/inatrUSana_ditekSana_ejeMta#inatrujZana_ditekSana_ejeMta/inatruSana_ditekSana_ejeMta/inatrUSana_ditekSana_ejeMta#noun#3#RM
intrusion_detection_domain	inatrUSZana_ditekSana_domena#inatrUSZana_ditekSana_domena#noun#3#RM
intrusion_detection_system	aMwarveXana_saMsUcana_praNAlI/intrUSZana_ditekSana_sistama#aMwarveXana_saMsUcana_praNAlI/intrUSZana_ditekSana_sistama#noun#3#RM
intrusion_detection_systems	inatrujZana_ditekSana_sistamsa/iMtrujZana_ditekSana_sistamsa#inatrujZana_ditekSana_sistamsa/iMtrujZana_ditekSana_sistamsa#noun#3#RM
inversely_proportional	prawIpAnupAwI/inavarsalI_praporSanala#prawIpAnupAwI/inavarsalI_praporSanala#noun#2#RM
ip_address	AIpI_edresa/AI_pI_Edrasa#AIpI_edresa/AI_pI_Edrasa#noun#2#RM
isa_relationship	ijae_rileSanSipa#ijae_rileSanSipa#noun#2#RM
iterative_deepening	itaretiva_dIpaniMga#itaretiva_dIpaniMga#noun#2#RM
iterative_deepening_a*	itaretiva_dIpaniMga_A_stAra#itaretiva_dIpaniMga_A_stAra#noun#3#RM
iterative_way	punarAvqwwi_warIkA/itaretiva_ve#punarAvqwwi_warIkA/itaretiva_ve#noun#2#RM
kit_generation_test	kita_janareSana_testa#kita_janareSana_testa#noun#3#RM
knowledge_base	noYleja_besa#noYleja_besa#noun#2#RM
knowledge_representation	jAnakArI_nirUpaNa/noYleja_reprajZentESana#jAnakArI_nirUpaNa/noYleja_reprajZentESana#noun#2#RM
knowledge_representation_scheme	jAnakArI_nirUpaNa_yojanA/noYleja_reprajZentESana_skIma/noYleja_reprajZentESana_skImsa#jAnakArI_nirUpaNa_yojanA/noYleja_reprajZentESana_skIma/noYleja_reprajZentESana_skImsa#noun#3#RM
knowledge_representation_schemes	jAnakArI_nirUpaNa_yojanAez/noYleja_reprajZentESana_skImsa/jAnakArI_nirUpaNa_yojanAoM#jAnakArI_nirUpaNa_yojanAez/noYleja_reprajZentESana_skImsa/jAnakArI_nirUpaNa_yojanAoM#noun#3#RM
knowledge_representation_technique	jAnakArI_nirUpaNa_wakanIka/noYleja_reprajZentESana_teknIka#jAnakArI_nirUpaNa_wakanIka/noYleja_reprajZentESana_teknIka#noun#3#RM
land_attack	lEMda_atEka#lEMda_atEka#noun#2#RM
late_binding	leta_bAiMdiMga#leta_bAiMdiMga#noun#2#RM
leaf_node	lIPa_noda/((/lIPa_nodsa#lIPa_noda/((/lIPa_nodsa#noun#2#RM
leaf_nodes	lIPa_nodsa#lIPa_nodsa#noun#2#RM
legal_move	vEXa_cAla/lIgala_mUva#vEXa_cAla/lIgala_mUva#noun#2#RM
legal_move_generator	vEXa_cAla_janaretara/lIgala_mUva_janaretara#vEXa_cAla_janaretara/lIgala_mUva_janaretara#noun#3#RM
legal_moves	vEXa_cAleM/lIgala_mUvaja#vEXa_cAleM/lIgala_mUvaja#noun#2#RM
linear_space_search_strategy	liniyara_spesa_sarca_strEtejI#liniyara_spesa_sarca_strEtejI#noun#4#RM
local_heuristic_function	lokala_hyUristika_PaMkSana#lokala_hyUristika_PaMkSana#noun#3#RM
local_maxima	lokala_mEksimA/sApekRika_ucciRta_Palana#lokala_mEksimA/sApekRika_ucciRta_Palana#noun#2#RM
local_minima	lokala_minimA/lokala_minImA#lokala_minimA/lokala_minImA#noun#2#RM
local_minimum	lokala_minimama/lokala_mEksimama#lokala_minimama/lokala_mEksimama#noun#2#RM
machine_learning	maSIna_larniMga#maSIna_larniMga#noun#2#RM
maneuvering_process	manyuveriMga_prosesa#manyuveriMga_prosesa#noun#2#RM
maneuvering_program	manyuveriMga_progrAma#manyuveriMga_progrAma#noun#2#RM
mass_resonance_spectrometer	xravyamAna_anunAxa_spektromItara/mAsa_rejoneMsa_spektromItara#xravyamAna_anunAxa_spektromItara/mAsa_rejoneMsa_spektromItara#noun#3#RM
mathematical_induction	gaNiwIya_preraNa/mEWamEtikala_indakSana#gaNiwIya_preraNa/mEWamEtikala_indakSana#noun#2#RM
mathematical_process	gaNiwIya_prakriyA/mEWamEtikala_prosesa#gaNiwIya_prakriyA/mEWamEtikala_prosesa#noun#2#RM
matrix_value	AvyUha_mAna/mEtriksa_vElyU#AvyUha_mAna/mEtriksa_vElyU#noun#2#RM
max_layer	aXikawama_parawa/mEksa_leyara#aXikawama_parawa/mEksa_leyara#noun#2#RM
maximum_layer	aXikawama_parawa/mEksimama_leyara#aXikawama_parawa/mEksimama_leyara#noun#2#RM
maximum_level	aXikawama_swara/mEksimama_levala#aXikawama_swara/mEksimama_levala#noun#2#RM
maximum_or_minimum_value	aXikawama_mAna/mEksimama_vElyU#aXikawama_mAna/mEksimama_vElyU#noun#4#RM
maximum_or_minimum_values	aXikawama_yA_nyUnawama_mAnoM/mEksimama_oYra_minimama_vElyUja#aXikawama_yA_nyUnawama_mAnoM/mEksimama_oYra_minimama_vElyUja#noun#4#RM
maximum_value	aXikawama_mAna/mEksimama_vElyU#aXikawama_mAna/mEksimama_vElyU#noun#2#RM
membership_grade	membarSipa_greda#membarSipa_greda#noun#2#RM
memory-based_planning	memorI-besda_plAniMga#memorI-besda_plAniMga#noun#2#RM
memory_bound	memorI_bAunda#memorI_bAunda#noun#2#RM
memory_bound_searches	memorI_bAunda_sarceja/memorI_bAunda_sarcesa#memorI_bAunda_sarceja/memorI_bAunda_sarcesa#noun#3#RM
memory_optimized_algorithms	memorI_oYptimAijZda_algorixamsa#memorI_oYptimAijZda_algorixamsa#noun#3#RM
memory_organized_pockets	memorI_oYrgenAijZda_poYketsa#memorI_oYrgenAijZda_poYketsa#noun#3#RM
mental_transformation	meMtala_trAMsaParmeSana#meMtala_trAMsaParmeSana#noun#2#RM
milk_jug_problem	milka_jaga_problama#milka_jaga_problama#noun#3#RM
min-max_layer	nyUnawama-aXikawama_parawa/mina-mEksa_leyara#nyUnawama-aXikawama_parawa/mina-mEksa_leyara#noun#2#RM
min_layer	nyUnawama_parawa/mina_leyara#nyUnawama_parawa/mina_leyara#noun#2#RM
mini_maxima	minI_mEksimA#minI_mEksimA#noun#2#RM
minimax_algorithm	minimEksa_algorixama/minimEksa_elgorixama#minimEksa_algorixama/minimEksa_elgorixama#noun#2#RM
minimax_layers	minimEksa_leyarsa#minimEksa_leyarsa#noun#2#RM
minimum_and_maximum_layer	nyUnawama_Ora_aXikawama_parawa/minimama_eMda_mEksimama_leyara#nyUnawama_Ora_aXikawama_parawa/minimama_eMda_mEksimama_leyara#noun#4#RM
minimum_layer	nyUnawama_parawa/minimama_leyara#nyUnawama_parawa/minimama_leyara#noun#2#RM
minimum_level	nyUnawama_swara/minimama_levala#nyUnawama_swara/minimama_levala#noun#2#RM
minimum_value	nyUnawama_mAna/minimama_vElyU#nyUnawama_mAna/minimama_vElyU#noun#2#RM
missionary_cannibal_problem	pAxarI_naraBakRI_samasyA/miSanarI_kEnibala_problama#pAxarI_naraBakRI_samasyA/miSanarI_kEnibala_problama#noun#3#RM
missionary_cannibal_program	miSanarI_naraBakRI_progrAma#miSanarI_naraBakRI_progrAma#noun#3#RM
mobile_agents	mobAila_ejeMtsa#mobAila_ejeMtsa#noun#2#RM
mobile_and_multi_agent_games	mobAila_Ora_maltI_ejeMta_gemsa#mobAila_Ora_maltI_ejeMta_gemsa#noun#5#RM
momentum_factor	gawi_kAraka/momeMtama_PEktara#gawi_kAraka/momeMtama_PEktara#noun#2#RM
move_generator	mUva_janaretara#mUva_janaretara#noun#2#RM
movegen_function	mUva_jena_PaMkSana#mUva_jena_PaMkSana#noun#2#RM
multi-layer_network	bahu-parawa_netavarka/maltI-leyara_netavarka#bahu-parawa_netavarka/maltI-leyara_netavarka#noun#2#RM
multi-layer_neural_network	maltI-leyara_nyUrala_netavarka#maltI-leyara_nyUrala_netavarka#noun#3#RM
multi-layer_neuron	maltI-leyara_nyUroYna#maltI-leyara_nyUroYna#noun#2#RM
multi-layer_perceptron	maltI-leyara_paraseptroYna#maltI-leyara_paraseptroYna#noun#2#RM
multi_agent_game	maltI_ejeMta_gema#maltI_ejeMta_gema#noun#3#RM
multi_agent_games	maltI_ejeMta_gemsa#maltI_ejeMta_gemsa#noun#3#RM
multi_core	bahu_kora/malti_kora#bahu_kora/malti_kora#noun#2#RM
multi_layer_network	maltI_leara_netavarka#maltI_leara_netavarka#noun#3#RM
multi_layer_neural_network	maltI_leara_nyUrala_netavarka#maltI_leara_nyUrala_netavarka#noun#4#RM
multiple_hidden_layers	bahula_CipI_parawe/maltIpala_hidana_leyarsa/bahula_CipI_paraweM#bahula_CipI_parawe/maltIpala_hidana_leyarsa/bahula_CipI_paraweM#noun#3#RM
multiple_inheritance	maltIpala_inheritansa#maltIpala_inheritansa#noun#2#RM
multiple_layers	bahula_parawoM/maltIpala_leyarsa#bahula_parawoM/maltIpala_leyarsa#noun#2#RM
myers-briggs_model	mAyarsa-brigsa_moYdala#mAyarsa-brigsa_moYdala#noun#2#RM
n-dimensional_space	N-dimenSanala_spesa#N-dimenSanala_spesa#noun#2#RM
n_dimensional_space	N_dAimenSanala_spesa#N_dAimenSanala_spesa#noun#3#RM
natural_language_understanding_system	nEcurala_lEMgaveja_aMdarastEMdiMga_sistama#nEcurala_lEMgaveja_aMdarastEMdiMga_sistama#noun#4#RM
nearest_neighbor	niyaresta_nebara#niyaresta_nebara#noun#2#RM
nearest_neighbor_algorithm	niyaresta_nebara_elgorixama/niyaresta_nebara_kalanaviXi#niyaresta_nebara_elgorixama/niyaresta_nebara_kalanaviXi#noun#3#RM
negative_infinity	negetivainPinitI#negetivainPinitI#noun#2#RM
negative_misclassification	qNa_galawa_vargIkaraNa/negetiva_misaklAsiPikeSana/nigetiva_miskalAsiPikeSana/negetiva_miskalAsiPikeSana#qNa_galawa_vargIkaraNa/negetiva_misaklAsiPikeSana/nigetiva_miskalAsiPikeSana/negetiva_miskalAsiPikeSana#noun#2#RM
negative_value	qNAwmaka_mAna/negetiva_vElyU#qNAwmaka_mAna/negetiva_vElyU#noun#2#RM
negative_values	negetiva_velyUja#negetiva_velyUja#noun#2#RM
negatively_misclassification	negetivalI_miskalAsiPikeSana#negetivalI_miskalAsiPikeSana#noun#2#RM
neighborhood_functions	nebarahuda_PaMkSansa#nebarahuda_PaMkSansa#noun#2#RM
neighbourhood_function	nebarahuda_PaMkSana#nebarahuda_PaMkSana#noun#2#RM
network_protocol_problem	netavarka_protokoYla_problama#netavarka_protokoYla_problama#noun#3#RM
neural_network	waMwrikA_netavarka/nyUrala_netavarka/waMwrikIya_waMwra#waMwrikA_netavarka/nyUrala_netavarka/waMwrikIya_waMwra#noun#2#RM
neural_network_program	waMwrikA_netavarka_progrAma/nyUrala_netavarka_progrAma#waMwrikA_netavarka_progrAma/nyUrala_netavarka_progrAma#noun#3#RM
neural_networks	waMwrikA_netavarka/nyUrala_netavarksa/waMwrikA_netavarksa#waMwrikA_netavarka/nyUrala_netavarksa/waMwrikA_netavarksa#noun#2#RM
ninth_state	nInWa_steta#nInWa_steta#noun#2#RM
non-monotonic_reasoning_system	noYna-monotonika_rIjZaniMga_sistama#noYna-monotonika_rIjZaniMga_sistama#noun#3#RM
non-optimal_path	gEra-anukUlawama_mArga/noYna_oYptimala_pAWa#gEra-anukUlawama_mArga/noYna_oYptimala_pAWa#noun#2#RM
non_monotonic_reasoning_system	noYna_monotonika_rIjZaniMga_sistama#noYna_monotonika_rIjZaniMga_sistama#noun#4#RM
non_optimal_solutions	noYna_oYptImala_soYlyUSansa#noYna_oYptImala_soYlyUSansa#noun#3#RM
nonlinear_planning	noYnaliniyara_plAniMga#noYnaliniyara_plAniMga#noun#2#RM
null_statement	nala_stetameMta#nala_stetameMta#noun#2#RM
object-_oriented	oYbjekta_orieMteda#oYbjekta_orieMteda#noun#2#RM
object_oriented_programming	oYbjekta_orieMteda_progrAmiMga#oYbjekta_orieMteda_progrAmiMga#noun#3#RM
object_oriented_programming_languages	oYbjekta_orieMteda_progrAmiMga_lEMgvejesa#oYbjekta_orieMteda_progrAmiMga_lEMgvejesa#noun#4#RM
objective_function	oYbjektiva_PaMkSana#oYbjektiva_PaMkSana#noun#2#RM
objective_function_value	oYbjektiva_PaMkSana_vElyU#oYbjektiva_PaMkSana_vElyU#noun#3#RM
objective_probability	oYbjektiva_probebilitI#oYbjektiva_probebilitI#noun#2#RM
odd_moves	viRama_cAleM/oda_mUvaja#viRama_cAleM/oda_mUvaja#noun#2#RM
operating_system	oYparetiMga_sistama#oYparetiMga_sistama#noun#2#RM
optimal_function	oYptimala_PaMkSana#oYptimala_PaMkSana#noun#2#RM
optimal_functions	oYptImala_PaMkSansa#oYptImala_PaMkSansa#noun#2#RM
optimal_path	anukUlawama_mArga/oYptimala_pAWa#anukUlawama_mArga/oYptimala_pAWa#noun#2#RM
optimal_plan	oYptImala_plAna#oYptImala_plAna#noun#2#RM
optimal_solution	oYptimala_soYlyUSana/oYptimala_solyUSana/oYptImala_soYlyUSana/oYptImala_solyUSana#oYptimala_soYlyUSana/oYptimala_solyUSana/oYptImala_soYlyUSana/oYptImala_solyUSana#noun#2#RM
or_arc	oYra_arka#oYra_arka#noun#2#RM
order_crossover	oYrdara_kroYsaovara#oYrdara_kroYsaovara#noun#2#RM
ordinal_representation	oYrdinala_riprajeMteSana#oYrdinala_riprajeMteSana#noun#2#RM
output_layer	Autaputa_parawa/Autaputa_leara/Autaputa_leyara#Autaputa_parawa/Autaputa_leara/Autaputa_leyara#noun#2#RM
output_unit	Autaputa_ikAiyoM/Autaputa_yUnita/Autaputa_ikAI#Autaputa_ikAiyoM/Autaputa_yUnita/Autaputa_ikAI#noun#2#RM
output_units	Autaputa_ikAiyAz/Autaputa_yUnitsa/Autaputa_ikAiyoM/Autaputa_ikAIyoM#Autaputa_ikAiyAz/Autaputa_yUnitsa/Autaputa_ikAiyoM/Autaputa_ikAIyoM#noun#2#RM
output_value	AutaputavElyU#AutaputavElyU#noun#2#RM
parallel_processing	samAnAMwara_prakramaNa/pEralala_prosesiMga#samAnAMwara_prakramaNa/pEralala_prosesiMga#noun#2#RM
parent_node	pEreMta_noda/pEreMtanoda_noda#pEreMta_noda/pEreMtanoda_noda#noun#2#RM
parent_value	pereMta_velyU#pereMta_velyU#noun#2#RM
parking_sensor_node	pArkiMga_seMsara_noda#pArkiMga_seMsara_noda#noun#3#RM
partial_ordering	pArSiyala_oYrdariMga#pArSiyala_oYrdariMga#noun#2#RM
partial_solutions	pArSiyala_solyUSansa#pArSiyala_solyUSansa#noun#2#RM
partially_mapped_crossover	pArSiyalI_mEpda_kroYsaovara#pArSiyalI_mEpda_kroYsaovara#noun#3#RM
partition_semantic_net	pArtiSana_simEMtika_neta#pArtiSana_simEMtika_neta#noun#3#RM
password_cracker	pAsavarda_krEkara#pAsavarda_krEkara#noun#2#RM
path_representation	pAWa_riprajeMteSana#pAWa_riprajeMteSana#noun#2#RM
percept_sequence	parasepta_sIkveMsa/parsepta_sIkveMsa#parasepta_sIkveMsa/parsepta_sIkveMsa#noun#2#RM
permutation_and_combination	kramacaya_Ora_saMcaya/paramyuteSana_Ora_koYmbineSana#kramacaya_Ora_saMcaya/paramyuteSana_Ora_koYmbineSana#noun#3#RM
perturbation_search	partarbeSana_Koja/partarbeSana_sarca#partarbeSana_Koja/partarbeSana_sarca#noun#2#RM
pheromone_value	Peromona_vElyU#Peromona_vElyU#noun#2#RM
pheromone_values	Peromona_vElyUja#Peromona_vElyUja#noun#2#RM
physical_symbol_system	BOwika_prawIka_praNAlI/Pijikala_simbala_sistama#BOwika_prawIka_praNAlI/Pijikala_simbala_sistama#noun#3#RM
physical_symbol_system_hypothesis	BOwika_prawIka_praNAlI_parikalpanA/Pijikala_simbala_sistama_hAipoWisisa#BOwika_prawIka_praNAlI_parikalpanA/Pijikala_simbala_sistama_hAipoWisisa#noun#4#RM
physical_transformation	Pijikala_trAMsaParmeSana#Pijikala_trAMsaParmeSana#noun#2#RM
picture_aiders	ciwra_sahAyaka/pikcara_edarsa#ciwra_sahAyaka/pikcara_edarsa#noun#2#RM
picture_producer	pikcara_pradyUsara#pikcara_pradyUsara#noun#2#RM
picture_producers	pikcara_pradyUsarsa#pikcara_pradyUsarsa#noun#2#RM
piece_exchange	pIsa_eksceMja#pIsa_eksceMja#noun#2#RM
pixel_value	piksela_mAna/piksela_vElyU#piksela_mAna/piksela_vElyU#noun#2#RM
plan_space_planning	plAna_spesa_plAniMga#plAna_spesa_plAniMga#noun#3#RM
plan_stack_planning	plAna_stEka_plAniMga#plAna_stEka_plAniMga#noun#3#RM
planning_process	plAniMga_prosesa/plAniM_prosesa#plAniMga_prosesa/plAniM_prosesa#noun#2#RM
plausible_move	svIkArya_cAla/ploYjZabala_mUva#svIkArya_cAla/ploYjZabala_mUva#noun#2#RM
plausible_move_generator	ploYjZabala_mUva_janaretara/svIkArya_cAla_janaretara#ploYjZabala_mUva_janaretara/svIkArya_cAla_janaretara#noun#3#RM
plausible_move_generators	svIkArya_cAla_janaretaroM/ploYjZabala_mUva_janaretaroM#svIkArya_cAla_janaretaroM/ploYjZabala_mUva_janaretaroM#noun#3#RM
plausible_moves	svIkArya_cAleM/ploYjZabala_mUvaja/svIkArya_cAloM#svIkArya_cAleM/ploYjZabala_mUvaja/svIkArya_cAloM#noun#2#RM
ply_search	plAI_sarca#plAI_sarca#noun#2#RM
positive_infinity	poYjitiva_inPinitI#poYjitiva_inPinitI#noun#2#RM
positive_misclassification	Xana_galawa_vargIkaraNa/poYjitiva_misaklAsiPikeSana/poYjitiva_miskalAsiPikeSana#Xana_galawa_vargIkaraNa/poYjitiva_misaklAsiPikeSana/poYjitiva_miskalAsiPikeSana#noun#2#RM
positive_value	Xana_mAna/poYjitiva_vElyU#Xana_mAna/poYjitiva_vElyU#noun#2#RM
positive_values	pojitiva_velyUja#pojitiva_velyUja#noun#2#RM
positively_misclassification	poYjItivalI_miskalAsiPikeSana#poYjItivalI_miskalAsiPikeSana#noun#2#RM
possessed_by	posesda_bAI#posesda_bAI#noun#2#RM
power_point	poYvara_poYiMta#poYvara_poYiMta#noun#2#RM
power_point_animation	poYvara_poYiMta_enImeSana#poYvara_poYiMta_enImeSana#noun#3#RM
predicate_act	viXeya_cara/prediketa_ekta#viXeya_cara/prediketa_ekta#noun#2#RM
predicate_logic	nirXAraka_warka/prediketa_loYjika/predIketa_loYjika#nirXAraka_warka/prediketa_loYjika/predIketa_loYjika#noun#2#RM
predicate_logic_problems	nirXAraka_warka_problamsa/predIketa_loYjika_problamsa#nirXAraka_warka_problamsa/predIketa_loYjika_problamsa#noun#3#RM
predicate_value	nirXAraka_mAna/prediketa_vElyU#nirXAraka_mAna/prediketa_vElyU#noun#2#RM
previous_percepts	priviasa_paraseptsa#priviasa_paraseptsa#noun#2#RM
problem_reduction_system	problama_ridakSana_sistama#problama_ridakSana_sistama#noun#3#RM
problem_space	problama_spesa#problama_spesa#noun#2#RM
problem_state	problama_steta#problama_steta#noun#2#RM
problems_reduction_algorithm	problemsa_ridakSana_algoriWama#problemsa_ridakSana_algoriWama#noun#3#RM
processing_time	prosesiMga_tAima#prosesiMga_tAima#noun#2#RM
production_rules	prodakSana_rUlsa#prodakSana_rUlsa#noun#2#RM
programming_language	progrAmiMga_lEMgveja#progrAmiMga_lEMgveja#noun#2#RM
prolog_program	proloYga_progrAma#proloYga_progrAma#noun#2#RM
propositional_and_predicate_logic	prapojZiSanala_Ora_nirXAraka_warka/prapojZiSanala_eMda_prediketa_loYjika#prapojZiSanala_Ora_nirXAraka_warka/prapojZiSanala_eMda_prediketa_loYjika#noun#4#RM
propositional_logic	prapojZiSanala_loYjika#prapojZiSanala_loYjika#noun#2#RM
pseudo_code	sUdo_koda#sUdo_koda#noun#2#RM
random_node	rEMdama_noda#rEMdama_noda#noun#2#RM
random_sequences	yAxqcCika_anukramoM/reMdama_sikveMsesa#yAxqcCika_anukramoM/reMdama_sikveMsesa#noun#2#RM
random_set	yAxqcCika_seta/reMdama_seta#yAxqcCika_seta/reMdama_seta#noun#2#RM
random_solution	yAxqcCika_samAXAna/reMdama_solyUSana#yAxqcCika_samAXAna/reMdama_solyUSana#noun#2#RM
random_walk	rEMdama_voYka#rEMdama_voYka#noun#2#RM
real_random_inheritance	vAswavika_yAxqcCika_virAsawa/riyala_rEndama_inaheritensa#vAswavika_yAxqcCika_virAsawa/riyala_rEndama_inaheritensa#noun#3#RM
real_space	riyala_spesa#riyala_spesa#noun#2#RM
real_time	riyala_tAima/vAswavika_samaya/riyala_tAIma/vAswavika_samaya_sImA#riyala_tAima/vAswavika_samaya/riyala_tAIma/vAswavika_samaya_sImA#noun#2#RM
recipient_case_relationship	resipienta_kesa_rileSanSipa#resipienta_kesa_rileSanSipa#noun#3#RM
recursive_algorithm	punarAvarwI_kalana_viXi/rikarsiva_elgorixama#punarAvarwI_kalana_viXi/rikarsiva_elgorixama#noun#2#RM
recursive_best_first	rikarsiva_besta_Parsta#rikarsiva_besta_Parsta#noun#3#RM
recursive_best_first_search	rikarsiva_besta_Parsta_sarca#rikarsiva_besta_Parsta_sarca#noun#4#RM
recursive_call	punarAvarwI_koYla/rikarsiva_koYla#punarAvarwI_koYla/rikarsiva_koYla#noun#2#RM
recursive_process	punarAvqwwi_prakriyA/rikarsiva_prosesa#punarAvqwwi_prakriyA/rikarsiva_prosesa#noun#2#RM
recursive_PaMkSana	punarAvarwI_PaMkSana/rikarsiva_PaMkSana#punarAvarwI_PaMkSana/rikarsiva_PaMkSana#noun#2#RM
red_node	reda_noda#reda_noda#noun#2#RM
refinement_search	pariSoXiwa_Koja/riPAinameMta_sarca/pariRkqwa_Koja/riPAiMmeMta_sarca#pariSoXiwa_Koja/riPAinameMta_sarca/pariRkqwa_Koja/riPAiMmeMta_sarca#noun#2#RM
relative_degree	reletiva_digrI#reletiva_digrI#noun#2#RM
relevant_actions	relevanta_ekSaMsa#relevanta_ekSaMsa#noun#2#RM
resolution_process	rejZalUSana_prosesa#rejZalUSana_prosesa#noun#2#RM
robot_domain	robota_domena#robota_domena#noun#2#RM
root_level	rUta_levala#rUta_levala#noun#2#RM
root_node	rUta_noda#rUta_noda#noun#2#RM
roots_estimate	rUtsa_estimeta#rUtsa_estimeta#noun#2#RM
row_value	ro_vElyU#ro_vElyU#noun#2#RM
rule_of_thumbs	rUla_oYPa_Wamba#rUla_oYPa_Wamba#noun#3#RM
script_kiddies	skripta_kiddIja#skripta_kiddIja#noun#2#RM
search_algorithm	Koja_kalana_viXi/sarca_elgorixama/Koja_kalanaviXi#Koja_kalana_viXi/sarca_elgorixama/Koja_kalanaviXi#noun#2#RM
search_algorithms	sarca_algorixamsa/sarca_elgorixamsa#sarca_algorixamsa/sarca_elgorixamsa#noun#2#RM
search_function	sarca_PaMkSana#sarca_PaMkSana#noun#2#RM
search_method	Koja_viXi/sarca_meWada/sarca_mEWada#Koja_viXi/sarca_meWada/sarca_mEWada#noun#2#RM
search_methods	Koja_viXiyAz/sarca_meWadsa/sarca_mEWadsa/Koja_viXiyoM/Koja_viXi#Koja_viXiyAz/sarca_meWadsa/sarca_mEWadsa/Koja_viXiyoM/Koja_viXi#noun#2#RM
search_problems	Koja_samasyAoM/sarca_problamsa#Koja_samasyAoM/sarca_problamsa#noun#2#RM
search_process	Koja_prakriyA/sarca_prosesa/Koja_prosesa#Koja_prakriyA/sarca_prosesa/Koja_prosesa#noun#2#RM
search_space	sarca_spesa#sarca_spesa#noun#2#RM
search_spaces	sarca_spesijZa/sarca_spesejZa#sarca_spesijZa/sarca_spesejZa#noun#2#RM
search_tree	sarca_trI#sarca_trI#noun#2#RM
search_trees	sarca_trIja#sarca_trIja#noun#2#RM
second_order_logic	xviwIya_krama_warka/sekaMda_oYrdara_loYjika#xviwIya_krama_warka/sekaMda_oYrdara_loYjika#noun#3#RM
second_order_predicate_logic	xviwIya_krama_nirXAraka_warka/sekaMda_oYrdara_predIketa_loYjika#xviwIya_krama_nirXAraka_warka/sekaMda_oYrdara_predIketa_loYjika#noun#4#RM
secondary_search	xviwIyaka_Koja/sekeMdarI_sarca#xviwIyaka_Koja/sekeMdarI_sarca#noun#2#RM
selection_process	cayana_prakriyA/silekSana_prosesa#cayana_prakriyA/silekSana_prosesa#noun#2#RM
selective_search	cayanAwmaka_Koja/silektiva_sarca#cayanAwmaka_Koja/silektiva_sarca#noun#2#RM
semantic_net	simEMtika_neta#simEMtika_neta#noun#2#RM
semantic_network	arWa_vinyAsI_waMwra/simeMtika_netavarka/simEMtika_netavarka#arWa_vinyAsI_waMwra/simeMtika_netavarka/simEMtika_netavarka#noun#2#RM
semi_human	semI_hyUmana#semI_hyUmana#noun#2#RM
sequential_and_causal_relationship	sikvenSala_eMda_koYjZala_rileSanSipa#sikvenSala_eMda_koYjZala_rileSanSipa#noun#4#RM
set_problems	seta_problamsa#seta_problamsa#noun#2#RM
short-listing_process	SoYrta-listiMga_prosesa#SoYrta-listiMga_prosesa#noun#2#RM
shortest_path	sabase_CotA_rAswA/Sortesta_pAWa/sabase_Cote_rAswe#sabase_CotA_rAswA/Sortesta_pAWa/sabase_Cote_rAswe#noun#2#RM
shortest_paths	sabase_Cote_rAswoM/Sortesta_pAWsa#sabase_Cote_rAswoM/Sortesta_pAWsa#noun#2#RM
sibling's_value	sibliMga'sa_vElyU#sibliMga'sa_vElyU#noun#2#RM
sigmoid_function	sigmAida_PaMkSana/sigmoida_PaMkSana#sigmAida_PaMkSana/sigmoida_PaMkSana#noun#2#RM
signaling_process	saMkewana_prakriyA/signaliMga_prosesa#saMkewana_prakriyA/signaliMga_prosesa#noun#2#RM
signature_recognition_system	haswAkRara_pahacAna_praNAlI/signecara_rekoYgnISana_sistama#haswAkRara_pahacAna_praNAlI/signecara_rekoYgnISana_sistama#noun#3#RM
simple_planning	simpala_plAniMga#simpala_plAniMga#noun#2#RM
simulated_annealing	simuletida_enIliMga/simuletida_ennIliMga/simuleteda_ennIliMga/simyuleteda_anIliMga/simyuleteda_enIliMga#simuletida_enIliMga/simuletida_ennIliMga/simuleteda_ennIliMga/simyuleteda_anIliMga/simyuleteda_enIliMga#noun#2#RM
simulated_hill_climbing	simyuleteda_hila_klAimbiMga#simyuleteda_hila_klAimbiMga#noun#3#RM
single_conceptualization	ekala_avaXAraNA/siMgala_kaMsepcyulAijZESana#ekala_avaXAraNA/siMgala_kaMsepcyulAijZESana#noun#2#RM
single_hidden_layer	ekala_CipI_parawa/siMgala_hidana_leyara#ekala_CipI_parawa/siMgala_hidana_leyara#noun#3#RM
single_layer	ekala_parawa/siMgala_leyara#ekala_parawa/siMgala_leyara#noun#2#RM
single_layer_perceptron.	siMgala_leyara_parsepatrona#siMgala_leyara_parsepatrona#noun#3#RM
single_point_crossover	siMgala_poYinta_kroYsaovara#siMgala_poYinta_kroYsaovara#noun#3#RM
skolem_constant	skoYlema_koYnsteMta#skoYlema_koYnsteMta#noun#2#RM
skolem_constants	skoYlema_koYnsteMtsa#skoYlema_koYnsteMtsa#noun#2#RM
skolem_function	skoYlema_PaMkSana#skoYlema_PaMkSana#noun#2#RM
soft_computing	soYPta_kampyUtiMga#soYPta_kampyUtiMga#noun#2#RM
soft_constraints	soYPta_streMntsa#soYPta_streMntsa#noun#2#RM
solution_path_calculation	soYlyUSana_pAWa_kElakuleSana#soYlyUSana_pAWa_kElakuleSana#noun#3#RM
solution_search	solyuSana_Koja/solyuSana_sarca/solyUSana_sarca#solyuSana_Koja/solyuSana_sarca/solyUSana_sarca#noun#2#RM
solution_search_method	solyuSana_Koja_viXi/solyuSana_sarca_meWada#solyuSana_Koja_viXi/solyuSana_sarca_meWada#noun#3#RM
solution_set	soYlyUSana_seta/solyUSana_seta#soYlyUSana_seta/solyUSana_seta#noun#2#RM
solution_space	soYlyUSana_spesa/solyuSana_spesa/solyUSana_spesa#soYlyUSana_spesa/solyuSana_spesa/solyUSana_spesa#noun#2#RM
solution_space_search	soYlyuSana_spesa_sarca/solyuSana_spesa_sarca/solyUSana_spesa_sarca#soYlyuSana_spesa_sarca/solyuSana_spesa_sarca/solyUSana_spesa_sarca#noun#3#RM
solution_state	solyUSana_steta#solyUSana_steta#noun#2#RM
solution_states	solyUSana_stetsa#solyUSana_stetsa#noun#2#RM
solutions_search	solyUSansa_sarca#solyUSansa_sarca#noun#2#RM
space_complexity	spesa_koYmpleksitI#spesa_koYmpleksitI#noun#2#RM
space_constraint	spesa_kansatreMta#spesa_kansatreMta#noun#2#RM
sparse_neighborhood	spArsa_nebarahuda#spArsa_nebarahuda#noun#2#RM
sparse_neighbourhood	deMsa_nebarahuda/spArsa_nebarahuda#deMsa_nebarahuda/spArsa_nebarahuda#noun#2#RM
sparse_neighbourhood_function	deMsa_nebarahuda_PaMkSana/spArsa_nebarahuda_PaMkSana#deMsa_nebarahuda_PaMkSana/spArsa_nebarahuda_PaMkSana#noun#3#RM
speech_recognition	spIca_rekagniSana#spIca_rekagniSana#noun#2#RM
speech_translation	bolI_anuvAxa/spIca_trAMsaleSana#bolI_anuvAxa/spIca_trAMsaleSana#noun#2#RM
speech_translation_problem	bolI_anuvAxa_progrAma/spIca_trAMsaleSana_progrAma/bolI_anuvAxa_problama/spIca_trAMsaleSana_problama#bolI_anuvAxa_progrAma/spIca_trAMsaleSana_progrAma/bolI_anuvAxa_problama/spIca_trAMsaleSana_problama#noun#3#RM
square_function	skveyara_PaMkSana#skveyara_PaMkSana#noun#2#RM
start_node	stArta_noda#stArta_noda#noun#2#RM
start_state	AraMBika_avasWA/stArta_steta#AraMBika_avasWA/stArta_steta#noun#2#RM
starting_node	stArtiMga_noda#stArtiMga_noda#noun#2#RM
state-space-search_star	steta-spesa-sarca_stAra#steta-spesa-sarca_stAra#noun#2#RM
state_space	steta_spesa#steta_spesa#noun#2#RM
state_space_representation	steta_spesa_reprajZenteSana#steta_spesa_reprajZenteSana#noun#3#RM
state_space_search	steta_spesa_sarca#steta_spesa_sarca#noun#3#RM
state_space_two	steta_spesa_tU#steta_spesa_tU#noun#3#RM
state_spaces	steta_spesejZa#steta_spesejZa#noun#2#RM
static_evaluation_function	stEtika_ivelyUeSana_PaMkSana/stEtika_ivElyUeSana_PaMkSana#stEtika_ivelyUeSana_PaMkSana/stEtika_ivElyUeSana_PaMkSana#noun#3#RM
static_evaluation_function_value	stEtika_ivelyUeSana_PaMkSana_vElyU#stEtika_ivelyUeSana_PaMkSana_vElyU#noun#4#RM
static_evaluation_functions	stEtika_ivElyUeSana_PaMkSansa#stEtika_ivElyUeSana_PaMkSansa#noun#3#RM
static_variables	sWEwika_cara/stEtika_verieblsa#sWEwika_cara/stEtika_verieblsa#noun#2#RM
statistical_reasoning	sAMKyikIya_warka/stetistikala_rIjZaniMga#sAMKyikIya_warka/stetistikala_rIjZaniMga#noun#2#RM
steepest_ascent_hill_climbing	stIpesta_eseMta_hila_klAimbiMga#stIpesta_eseMta_hila_klAimbiMga#noun#4#RM
storage_time	storeja_tAima#storeja_tAima#noun#2#RM
strict_ordering	strIkta_oYrdariMga#strIkta_oYrdariMga#noun#2#RM
structured_process	strakcarda_prosesa#strakcarda_prosesa#noun#2#RM
sub_goals	saba_golsa#saba_golsa#noun#2#RM
sub_optimal_solution	sabaoYptimala_solyUSana#sabaoYptimala_solyUSana#noun#3#RM
sub_trees	saba_trIja#saba_trIja#noun#2#RM
subjective_probability	sabjektiva_probebilitI#sabjektiva_probebilitI#noun#2#RM
suboptimal_functions	sabaoYptimala_PaMkSansa#sabaoYptimala_PaMkSansa#noun#2#RM
suboptimal_solution	sabaoYptimala_solyUSana#sabaoYptimala_solyUSana#noun#2#RM
supervised_learning	paryavekRiwa_SikRaNa/suparvAijZada_larniMga#paryavekRiwa_SikRaNa/suparvAijZada_larniMga#noun#2#RM
sussman_anomaly	sUsamEna_enomalI#sUsamEna_enomalI#noun#2#RM
sussman_problem	susmAna_problama#susmAna_problama#noun#2#RM
symbol_structure	prawIka_saMracanA/simbalsa_strakcara#prawIka_saMracanA/simbalsa_strakcara#noun#2#RM
symbol_structures	prawIka_saMracanAoM/simbalsa_strakcarsa#prawIka_saMracanAoM/simbalsa_strakcarsa#noun#2#RM
symbolic_representation	prawIkAwmaka_nirUpaNa/simbolika_reprajZentESana#prawIkAwmaka_nirUpaNa/simbolika_reprajZentESana#noun#2#RM
system_calls	sistama_koYlsa#sistama_koYlsa#noun#2#RM
tabu_search	tabu_sarca#tabu_sarca#noun#2#RM
targeted_attacks	tArageteda_atEksa#tArageteda_atEksa#noun#2#RM
terminating_criteria	tarminetiMga_krAiteriyA#tarminetiMga_krAiteriyA#noun#2#RM
three-prong_structure	WrI-proMga_strakcara#WrI-proMga_strakcara#noun#2#RM
three_dimensional_space	WrI_dAimenSanala_spesa#WrI_dAimenSanala_spesa#noun#3#RM
threshold_value	WreSaholda_vElyU#WreSaholda_vElyU#noun#2#RM
tic_tac_toe	tika_tEka_to#tika_tEka_to#noun#3#RM
tolerance_level	toYlareMsa_levala#toYlareMsa_levala#noun#2#RM
tolerance_value	toYlareMsa_vElyU#toYlareMsa_vElyU#noun#2#RM
transition_finished	trAMJiSana_PiniSada#trAMJiSana_PiniSada#noun#2#RM
transition_starting	trAMJiSana_stArtiMga#trAMJiSana_stArtiMga#noun#2#RM
traveling_salesman_problem	trEveliMga_selsamEna_proYblama/trEveliMga_selsamEna_problama#trEveliMga_selsamEna_proYblama/trEveliMga_selsamEna_problama#noun#3#RM
travelling_salesman_problem	trevaliMga_selsamena_problama/trEvaliMga_selsamena_proYblama/trEvaliMga_selsamena_problama/trEvaliMga_selsamEna_problama/trEveliMga_selsamena_problama#trevaliMga_selsamena_problama/trEvaliMga_selsamena_proYblama/trEvaliMga_selsamena_problama/trEvaliMga_selsamEna_problama/trEveliMga_selsamena_problama#noun#3#RM
two-dimensional_space	tU-_dimenSanala_spesa#tU-_dimenSanala_spesa#noun#2#RM
two_dimensional_space	tU_dAimenSanala_spesa#tU_dAimenSanala_spesa#noun#3#RM
unexplored_node	anaeksaplorada_noda/anaeksaplorda_noda/anaeksplordanoda#anaeksaplorada_noda/anaeksaplorda_noda/anaeksplordanoda#noun#2#RM
unexplored_nodes	anaeksaplorada_nodsa/anaeksaplorda_nodsa#anaeksaplorada_nodsa/anaeksaplorda_nodsa#noun#2#RM
unguided_search	anirxeSiwa_Koja/anagAideda_sarca#anirxeSiwa_Koja/anagAideda_sarca#noun#2#RM
unguided_search_method	anirxeSiwa_Koja_viXi/anagAideda_sarca_meWada#anirxeSiwa_Koja_viXi/anagAideda_sarca_meWada#noun#3#RM
unguided_search_methods	anirxeSiwa_Koja_viXi/anagAideda_sarca_meWada/anirxeSiwa_Koja_viXiyAM/anagAideda_sarca_meWadsa/anirxeSiwa_Koja_viXiyAz/anagAidida_sarca_mEWadsa/anirxeSiwa_Koja_viXiyoM#anirxeSiwa_Koja_viXi/anagAideda_sarca_meWada/anirxeSiwa_Koja_viXiyAM/anagAideda_sarca_meWadsa/anirxeSiwa_Koja_viXiyAz/anagAidida_sarca_mEWadsa/anirxeSiwa_Koja_viXiyoM#noun#3#RM
unification_algorithm	ekIkaraNa_kalana_viXi/yUniPikeSana_elgorixama#ekIkaraNa_kalana_viXi/yUniPikeSana_elgorixama#noun#2#RM
unification_process	ekIkaraNa_prakriyA/yUniPikeSana_prosesa#ekIkaraNa_prakriyA/yUniPikeSana_prosesa#noun#2#RM
universal_and_existential_quantifier	sArvaBOmika_Ora_aswiwvagawa_parimANaka/yUnivarsala_eMda_eksistenSiyala_kvAMtiPAyara#sArvaBOmika_Ora_aswiwvagawa_parimANaka/yUnivarsala_eMda_eksistenSiyala_kvAMtiPAyara#noun#4#RM
universal_and_existential_quantifiers	sArvaBOmika_Ora_aswiwvagawa_parimANakoM/yUnivarsala_eMda_eksistenSiyala_kvAMtiPAyarsa#sArvaBOmika_Ora_aswiwvagawa_parimANakoM/yUnivarsala_eMda_eksistenSiyala_kvAMtiPAyarsa#noun#4#RM
universal_quantifier	sArvaBOmika_parimANaka/yUnivarsala_kvAMtiPAyara/yUnivarsala_kvAMtiPAyarsa#sArvaBOmika_parimANaka/yUnivarsala_kvAMtiPAyara/yUnivarsala_kvAMtiPAyarsa#noun#2#RM
universal_quantifiers	sArvaBOmika_parimANakoM/yUnivarsala_kvAMtiPAyarsa#sArvaBOmika_parimANakoM/yUnivarsala_kvAMtiPAyarsa#noun#2#RM
unsupervised_learning	aparyavekRiwa_SikRaNa/anasuparvAijZada_larniMga#aparyavekRiwa_SikRaNa/anasuparvAijZada_larniMga#noun#2#RM
unwinding_phase	anavAiMdiMga_Pesa#anavAiMdiMga_Pesa#noun#2#RM
valley_descending	vElI_disendiMga#vElI_disendiMga#noun#2#RM
variable_binding_process	variebala_bAindiMga_prosesa#variebala_bAindiMga_prosesa#noun#3#RM
variable_descent	veriebala_diseMta#veriebala_diseMta#noun#2#RM
variable_descent_neighborhood_method	veriebala_diseMta_nebarahuda_meWada#veriebala_diseMta_nebarahuda_meWada#noun#4#RM
variable_mappings	cara_mEpiMgsa/variebala_mEpiMgsa#cara_mEpiMgsa/variebala_mEpiMgsa#noun#2#RM
variable_neighborhood_descent	veriebala_nebarahuda_diseMta#veriebala_nebarahuda_diseMta#noun#3#RM
variable_neighbourhood	veriebala_nebarahuda#veriebala_nebarahuda#noun#2#RM
variable_neighbourhood_descent	veriebala_nebarahuda_disenta#veriebala_nebarahuda_disenta#noun#3#RM
variable_neighbourhood_descent_function	veriebala_nebarahuda_disenta_PaMkSana#veriebala_nebarahuda_disenta_PaMkSana#noun#4#RM
variable_values	cara_mAna/variebala_vElyUja#cara_mAna/variebala_vElyUja#noun#2#RM
vector_value	saxiSa_mAna/vektara_vElyU#saxiSa_mAna/vektara_vElyU#noun#2#RM
vehicle_routing_problem	vehikala_rUtiMga_problama#vehikala_rUtiMga_problama#noun#3#RM
virtual_infinity	ABAsI_anaMwa/varcuala_inaPinitI#ABAsI_anaMwa/varcuala_inaPinitI#noun#2#RM
virus_scanners	vAyarasa_skEnarsa#vAyarasa_skEnarsa#noun#2#RM
voice_recognition_systems	voYyasa_rikagniSana_sistamsa#voYyasa_rikagniSana_sistamsa#noun#3#RM
von_neumann_architecture	voYna_nyUmEna_Arkitekcara#voYna_nyUmEna_Arkitekcara#noun#3#RM
water_jug_problem	vAtara_jaga_problama#vAtara_jaga_problama#noun#3#RM
web_ontology_language	veba_oYntoloYjI_lEMgveja#veba_oYntoloYjI_lEMgveja#noun#3#RM
weight_matrix	veta_mEtriksa#veta_mEtriksa#noun#2#RM
weighted_value	veteda_vElyU#veteda_vElyU#noun#2#RM
well-formed_formula	suvyavasWiwa_sUwra/vela-PoYrmda_PoYrmyUlA#suvyavasWiwa_sUwra/vela-PoYrmda_PoYrmyUlA#noun#2#RM
white_node	vhAita_noda#vhAita_noda#noun#2#RM
winding_and_unwinding_phase	vAiMdiMga_Ora_anavAiMdiMga_Pesa#vAiMdiMga_Ora_anavAiMdiMga_Pesa#noun#4#RM
winding_phase	vAiMdiMga_Pesa#vAiMdiMga_Pesa#noun#2#RM
winning_move	vijewA_cAla/viniMga_mUva#vijewA_cAla/viniMga_mUva#noun#2#RM
winning_moves	vijewA_cAleM/viniMga_mUvaja#vijewA_cAleM/viniMga_mUvaja#noun#2#RM
x3d_fritz	eksa_WrI_dI_Pritja#eksa_WrI_dI_Pritja#noun#2#RM
zero_sum	jZiro_sama#jZiro_sama#noun#2#RM
zero_sum_game	jZiro_sama_gema#jZiro_sama_gema#noun#3#RM
zero_sum_games	jZiro_sama_gemsa#jZiro_sama_gemsa#noun#3#RM
