an	eka/koI
a	eka/koI
vast	viswqwa
theory	siXxAMwa
fascinate	sammohiwa_kara
night	rAwri/rAwa
method	viXi/praNAlI
physics	BOwikI
to	ke_liye/kA
neither	na_wo
nor	na_hI
and	evaM
much	kAPI
around	ke_pariwaH/ke_iXara_uXara
financial	viwwa_saMbaMXiwa
accounting	leKAMkana
record-keeping	hisAba-kiwAb
however	waWApi
early	Axya
diverge	apasariwa
happen	pariNAma_ho
assume	mAnakara_cala
mechanism	yaMwra_vyavasWA
rotational	GUrNana
pioneer	paWa_praxarSaka
propagation	saFcaraNa
paraxial	upAkRIya
object	bimba
quantity	rASi
elastic	prawyAsWa
theorist	sixXAnwavAxI
least	sabase_kama
raindrop	varRA_kI_bUzxa
sunlight	sUrya_kA_prakASa/sUrya_ke_prakASa
refract	apavarwiwa_ho/apavarwiwa_kara
therefore	isa_prakAra
debate	vAxa_vivAxa
of	meM_se
relax	SiWila_ho
enormous	awyaXika
straight	sarala
travel	gamana_kara
construction	racanA
rectilinear	sarala_reKA
along	ke_anuxiSa
real-life	vAswavika_jIvana meM
such	isa_prakAra_kA
thus	awaeva
everywhere	hara_sWAna_para
friction	GarRaNa_bala	
breeze	manxa_pavana
preceding	piCale
signal	safkewa_xe
likewise	isI_prakAra
retard	manxa_kara
