Ora	and/other
evaM	and
waWA	and
yA	or
aWavA	or
anyaWA	or
hI	only
BI	also/too/even
ki	that
isa	the/this/such
eka	a/an/one
koI	a/an
kisI	a/an
hE	is/have
apane	his/its
apanI	the/our
usakI	his/its
usake	his/its
unakA	them
merA	i/me
vaha	she/he/the/her
yahAz	here
yaha	the/that/this/it
isakA	the/it/its/this
jinakA	which
hama	we
