usa_jagaha	vahAz/usa_jagaha
SiRtAcArahInawaH	asaByawaH/aSiRtawaH/SiRtAcArahInawaH
nyUnAXika	kamobeSa/kamabeSa/nyUnAXika
besAKwA	Jatapata/catapata/PatAPata/wuraMwa/wuranwa/wawkAla/avilaMba/avilamba/PZOrana/POrana/KatAka_se/wawkRaNa/wadZAka_se/wadZa_se/wapAka_se/awiSIGra/awiSIGrawaH/jalxa_se_jalxa/jalxI_se_jalxI/wadZa_se/hAWoM-hAWa/hAWoM_hAWa/hAWo-hAWa/hAWo_hAWa/Kata_se/Anana-PAnana_meM/AnanaPAnana_meM/siwAba/siwAbI/besAKwA/TahAkA/ikahAI/ikahAU
kRaNa-kRaNa	prawikRaNa/pala_pala/pala-pala/prawipala/hara_kRaNa/kRaNa-kRaNa/haraGadZI/hara_GadZI/prawi_kRaNa/kRaNakRaNa/anukRaNa/CinaCina/Cina-Cina/AKana
bAxahavAI	vyarWa/PZajUla/PijUla/PZijUla/anerA/yoM_hI/vqWA/apArWa/bAxa-havAI/bAxahavAI/ahewu/ahewuka/aviraWA
Wara-Wara	Wara-Wara/WaraWara
saMBAlakara	sAvaXAnIpUrvaka/XyAnapUrvaka/XyAna_se/sAvaXAnI_se/sAvaXAnawaH/samBAlakara/saMBAlakara
nissanxeha	niHsaMxeha/nissaMxeha/jarUra/jZarUra/niHsanxeha/nissanxeha/nisaMxeha/nisanxeha/binA_Saka/beSaka/bilkula/bilakula/yakInana/yakZInana/avaSyameva/avaSya/alabawwA/bilASaka/aBarama/vASinxA/bASinxA/avasi/aviwarkika/asaMSaya/niSciwawaH/ikaMka
gupwawaH	gupwawaH/gupacupa_rUpa_se/corI_Cipe
Agala	sAmane/Age/samakRa/sammuKa/agre/anvakRa/aBimuKa/xarapeSa/Agala/AgalA
IrRyAhInawaH	IrRyAhInawaH/anasUyawaH/xveRahInawaH
BOMcakkA	hakkA-bakkA/BOMcakkA/kiMkarwavya-vimUDZa/kiMkarwwavya-vimUDZa/kiMkarwavyavimUDZa/kiMkarwwavyavimUDZa/hawabuxXi
labAlaba	labAlaba/labareja/labarejZa
wadZake	sabere/savere/subaha/wadZake/subaha-subaha/subaha_savere
hara_GadZI	prawikRaNa/pala_pala/pala-pala/prawipala/hara_kRaNa/kRaNa-kRaNa/haraGadZI/hara_GadZI/prawi_kRaNa/kRaNakRaNa/anukRaNa/CinaCina/Cina-Cina/AKana
cAranAcAra	majabUrana/vivaSawaH/anacAhe/majZabUrana/vivaSa_hokara/cAranAcAra/aMwawogawvA/barabasa
Barasaka	yaWASakwi/Barasaka/yaWAsAXya/yaWAsaMBava/kRamawAnusAra/yaWAkRama
AgalA	sAmane/Age/samakRa/sammuKa/agre/anvakRa/aBimuKa/xarapeSa/Agala/AgalA
anavarawa	lagAwAra/anavarawa/niraMwara/niranwara/wAbadZawodZa/xanAxana/sawawa/XUAzXAra/anaMwara/ananwara/avirAmawaH/aniSa/prawikRaNa/anukRaNa/XadZAXadZa/avirawa/muwwasila/avicCinna/avicCexa/aviSrAnwa/aviSrAMwa/asarAra/aharaha/AsaMga/Asafga/ikawAra
kaI_bAra	kaI_bAra/bahuwa_bAra/anekaSaH
AKZirakAra	aMwawaH/aMwawogawvA/aMwa_meM/AKira/AKZira/AKZirakAra/AKirakAra/howe_havAwe
gaharAI_meM	gahare/gaharAI_meM
kramahInawaH	kramahInawaH/akramawaH/avyavasWiwawaH/jahAz_wahAz
ajo	aba_waka/aBI_waka/Aja_waka/abawaka/aBIwaka/Ajawaka/ajahuz/ajahUz/ajo/ajOM/abalaga
AxeSAnusAra	AjFAnusAra/AxeSAnusAra
vApisa	vApasa/vApisa
aMXAXuMXa	aMXAXuMXa/bewahASA/anXAXunXa/aMXaXuMXa/anXaXunXa/utakkara
yaWABIRta	icCAnusAra/icCAnukula/yaWecCa/yaWABIRta/yaWAvAMCiwa
saba_milAkara	kula_milAkara/saba_milAkara
aXika	Upara/aXika/jyAxA/jZyAxA/bahuwa/KZUba/KUba/badZA/jyAxA/jZyAxA/aXika/kAPZI/kAPI/kadZA/jamakara/datakara
pahale-pahala	pahale_pahala/praWamawaH/sarva_praWama/sarvapraWama/SurU_meM/pahale-pahala/avvalana/pahile_pahala/pahile_pahala
pata	pata/patta/petakEyAz
cupake-cupake	cupake_se/cupake-cupake/xaraparaxA
pUrexina	xinaBara/pUrexina
raPwA-raPwA	XIre-XIre/XIre_XIre/Ahiswe-Ahiswe/AhiswA-AhiswA/hOle-hOle/hole-hole/raPwA-raPwA/alpaSaH
Asa-pAsa	pAsa_meM/najZaxIka/najaxIka/nikata_meM/kZarIba_meM/samIpa/nikata/pAsa/kZarIba/karIba/sannikata/najIka/muwwasila/arvAka/avixUra/Are/AsapAsa/Asa-pAsa/Asa-pAsa/AsapAsa/agala-bagala/agZala-bagZala/AjU-bAjU/irxa-girxa/adZosa-padZosa/pAsa-padZosa/pAsa_padZosa
kadZAI_se	nirxayawApUrvaka/nirxayawA_se/berahamI_se/bexarxI_se/krUrawApUrvaka/barbarawApUrvaka/kaTorawA_se/kadZAI_se
meM	ke_aMxara/ke_anxara/ke_BIwara/meM
pUrvawaH	pahale_se/pUrvawaH/pahale_se_hI
agala-bagala	Asa-pAsa/AsapAsa/agala-bagala/agZala-bagZala/AjU-bAjU/irxa-girxa/adZosa-padZosa/pAsa-padZosa/pAsa_padZosa
pariNAmasvarUpa	PalasvarUpa/pariNAma_svarUpa/pariNAmasvarUpa/pariNAmawaH/PalawaH/nawIjawana
mAzgakara	mAzgakara/yAciwawaH
niwa	prawixina/haraxina/niwya/hararojZa/rojZa/niwa/roja/rojZAnA/rojAnA/anuxina/niwyaprawi/anuxivasa/aharaha
DaMga_se	viXipUrvaka/kZAyaxe_se/DaMga_se/warIkZe_se/bawOra/bAkZAyaxA/viXivaw/viXivawa
TaMDe_TaMDe	TaMde-TaMde/TaMde_TaMde/TaMDe-TaMDe/TaMDe_TaMDe
bAxa	bAxa/bAxa_meM/paScAw/uparAMwa/anaMwara/paScAwa/uparAnwa/ananwara/pICe/uwwara/aWa/anupaxa/anvakRa/pare/Age/bAxa
pahile_pahala	pahale_pahala/praWamawaH/sarva_praWama/sarvapraWama/SurU_meM/pahale-pahala/avvalana/pahile_pahala/pahile_pahala/pahale_pahala/praWamawaH/sarva_praWama/sarvapraWama/SurU_meM/pahale-pahala/avvalana/pahile_pahala/pahile_pahala
xanAxana	lagAwAra/anavarawa/niraMwara/niranwara/wAbadZawodZa/xanAxana/sawawa/XUAzXAra/anaMwara/ananwara/avirAmawaH/aniSa/prawikRaNa/anukRaNa/XadZAXadZa/avirawa/muwwasila/avicCinna/avicCexa/aviSrAnwa/aviSrAMwa/asarAra/aharaha/AsaMga/Asafga/ikawAra/xanAxana
BIwara	aMxara/anxara/BIwara/aMxara/anxara/BIwara
saxEva	hameSA/saxA/niwya/saxEva/niwya_prawi/sarvaxA/sarvaWA/haraxama/haravakwa/harasamaya/xina-rAwa/xinarAwa/xina_rAwa/rAwa-xina/rAwaxina/niSixina/nisa-vAsara/nisavAsara/niSivAsara/niranwara/niraMwara/anavaXi/sarvaxEva/aharaha/pinnA/aharniSa/ahorAwra
aparAXAnusAra	yaWAparAXa/aparAXAnusAra
apArWa	vyarWa/PZajUla/PijUla/PZijUla/anerA/yoM_hI/vqWA/apArWa/bAxa-havAI/bAxahavAI/ahewu/ahewuka/aviraWA
ke_aMxara	ke_aMxara/ke_anxara/ke_BIwara/meM
sAWa	sAWa-sAWa/sAWa_hI/sAWa_hI_sAWa/sAWa/eka_sAWa/ikatTA/ikajora/ekawra/ikawra
sahajawA_se	AsAnI_se/sahajawA_se/saralawA_se/Kela_Kela_meM/sahajawaH/anEse
wejZI_se	kasakara/joraxAra/weja/wejZa/wIvra/wejZI_se/jZora_se/wejI_se/jora_se/wIvrawA_se
labareja	labAlaba/labareja/labarejZa
AKirakAra	aMwawaH/aMwawogawvA/aMwa_meM/AKira/AKZira/AKZirakAra/AKirakAra/howe_havAwe
ekaMga	akelA/akele/kevala/sirPZa/mAwra/KAlI/KZAlI/basa/nipata/mahajZa/sirPa/wanhA/wanahA/ekAkI/ekameva/ekaMga/ikelA
rAwoM-rAwa	rAwoM-rAwa/rAwoMrAwa
SiRtawaH	SiRtawaH/saByawaH/bAsaUra/SAlInawaH/SiRtAcArapUrvaka/salIkZe_se
AjFApUrvaka	AjFApUrvaka/AxeSapUrvaka/sAxeSa/AxeSa_se
jZabarana	balapUrvaka/barabasa/jZabaraxaswI/jabaraxaswI/jZabarana/jabarana/barajZorI
niwAnwa	bilkula/bilakula/ekaxama/nipata/sarAsara/TIka/niwAMwa/niwAnwa/pUrNawaH/pUrI_waraha_se/pUrNawayA/saMpUrNawaH/saMpUrNawayA/pUrNarupeNa/AmUlacUla/Sawa-prawiSawa
sABAra	sABAra/kqwajFawApUrvaka
yaWeRta	paryApwa/kAPI/kAPZI/yaWeRta/alam/alaM
bAraMbAra	bAra-bAra/bAra_bAra/bAraMbAra/bArambAra/asakqwa/ahora-bahora
PUta-PUtakara	PUta-PUtakara/PUtaPUta_kara
savere	sabere/savere/subaha/wadZake/subaha-subaha/subaha_savere/jalxI/savere/sabere
yaWAvAMCiwa	icCAnusAra/icCAnukula/yaWecCa/yaWABIRta/yaWAvAMCiwa
akelA	akelA/akele/kevala/sirPZa/mAwra/KAlI/KZAlI/basa/nipata/mahajZa/sirPa/wanhA/wanahA/ekAkI/ekameva/ekaMga/ikelA
kZarIbana	aMxAjana/aMxAjZana/anxAjZana/anxAjana/lagaBaga/wakZarIbana/wakarIbana/kZarIba/karIba/karIbakarIba/karIbana/kZarIbakZarIba/kZarIbana/anumAnawaH/anakZarIba/anakarIba/waKZamInana/aMxAja_se/ukavAz
iXara	iXara/isa_ora/yahAz_para/iwaH/iwa/iwE/iwWe
bA-jAbwA	niyamAnusAra/yaWAniyama/bA-jAbwA
kAlha	kala/kAlha
mara-marakara	awyaXika_prayawnapUrvaka/mara-marakara
cAroM_waraPZa	cAroM_ora/cAroM_waraPZa/cAroM_waraPa/cahuz_ora/sarvawra/saBI_waraPZa/cAroM_xiSAoM_meM/hara_jagaha/irxa-girxa
baga-mela	bagamela/baga-mela
pravAha_kI_xiSA_meM	pravAha_kI_xiSA_meM/pravAha_kI_ora
samaya-samaya_para	samaya-samaya_para/bIca-bIca_meM
akele	akelA/akele/kevala/sirPZa/mAwra/KAlI/KZAlI/basa/nipata/mahajZa/sirPa/wanhA/wanahA/ekAkI/ekameva/ekaMga/ikelA
jZiMxagIBara	mqwyuparyanwa/AjIvana/wAumra/umraBara/jZiMxagIBara/jiMxagIBara/jIvanaBara/AmaraNa/aMwima_xama_waka
sAWa_hI	sAWa-sAWa/sAWa_hI/sAWa_hI_sAWa/sAWa/eka_sAWa/ikatTA/ikajora/ekawra/ikawra
xviguNiwa	xugunA/xUnA/xogunA/xuganA/xviguNa/xviguNiwa
XyAnapUrvaka	sAvaXAnIpUrvaka/XyAnapUrvaka/XyAna_se/sAvaXAnI_se/sAvaXAnawaH/samBAlakara/saMBAlakara
viSvasanIyawA_se	viSvAsa_ke_sAWa/viSvasanIyawA_se/viSvAsapUrvaka
yOM_hI	vyarWa_hI/yoM_hI/JUTa-mUTa/yOM_hI/yUz_hI/Ese_hI/nAhakZa/nAhaka/PZajZUla/PajUla/PZijZUla/PijUla/anahaka/anAhaka
xina-xina	xina-prawixina/xina-xina/xina-para-xina/xina-baxina/xina-ba_xina/xinaprawixina/xinaxina/xinabaxina/xinoM-xina/xinoMxina
mOnawaH	cupacApa/cupa/mOna/SAMwa/SAnwa/KZAmoSI_se/KAmoSI_se/niSSabxa/avAka/avAk/bina_bole/mOnawaH
aviSrAMwa	lagAwAra/anavarawa/niraMwara/niranwara/wAbadZawodZa/xanAxana/sawawa/XUAzXAra/anaMwara/ananwara/avirAmawaH/aniSa/prawikRaNa/anukRaNa/XadZAXadZa/avirawa/muwwasila/avicCinna/avicCexa/aviSrAnwa/aviSrAMwa/asarAra/aharaha/AsaMga/Asafga/ikawAra
BaviRya_meM	BaviRya_meM/Age/BaviRya_kAla_meM/agawyA
ukadUz	ukadZUz/ukadZU/ukadUz/ukadU/ukurU
kuSalapUrvaka	sakuSala/kuSalawApUrvaka/kuSalapUrvaka/sahI_salAmawa/sahI-salAmawa/TIka-TAka/TIka_se/TIka-TAka_se/TIkaTAka/baKZEra/baKEra/baKZErIya/baKErIyawa/surakRiwawaH
warawIba_se	warIkZe_se/warIke_se/warawIba_se/kZarIne_se/karIne_se/vyavasWApUrvaka/vyavasWiwawaH/kZarInAvAra/karInAvAra
kula_milAkara	kula_milAkara/saba_milAkara
aMwima_xama_waka	mqwyuparyanwa/AjIvana/wAumra/umraBara/jZiMxagIBara/jiMxagIBara/jIvanaBara/AmaraNa/aMwima_xama_waka
jaba	jaba/yaxA/yaxi/agara/jaba
Bara_meM	Bara_meM
ima	yoM/yUz/Ese/isa_waraha/isa_prakAra/EsA/iwWaM/ima/imi/iBa/iva/isE/IxqS/IxqSa
imi	yoM/yUz/Ese/isa_waraha/isa_prakAra/EsA/iwWaM/ima/imi/iBa/iva/isE/IxqS/IxqSa
saKZwa	awyaMwa/awyanwa/awyaXika/be-iMwahA/beiMwahA/bahuwa_aXika/bahuwa_hI/bepanAha/saKZwa/saKwa/jamakara/mahA/nihAyawa/cUdZAMwa/cUdZAnwa/aByaXika/Agara
jZora-Sora_se	jZora-Sora_se/jora-Sora_se/jZoraSora_se/joraSora_se/jZoroM_se/joroM_se
anwarjAnu	aMwarjAnu/anwarjAnu
umUmana	sAmAnyawaH/sAmAnyawayA/sAXAraNawaH/sAXAraNawayA/amUmana/umUmana
hameSA	hameSA/saxA/niwya/saxEva/niwya_prawi/sarvaxA/sarvaWA/haraxama/haravakwa/harasamaya/xina-rAwa/xinarAwa/xina_rAwa/rAwa-xina/rAwaxina/niSixina/nisa-vAsara/nisavAsara/niSivAsara/niranwara/niraMwara/anavaXi/sarvaxEva/aharaha/pinnA/aharniSa/ahorAwra
viSeRawaH	viSeRakara/KZAsakara/KZAsa_wOra_para/KZAsa_wOra_se/KZAsawOra_para/KZAsawOra_se/KAsawOra_para/KAsawOra_se/KAsakara/viSeRawaH/viSiRtawaH/muKyawaH/viSeRa_rUpa_se
AraMBawaH	AraMBa_meM/AraMBawaH/AramBawaH/pahale/SurU_meM/praWama/Axi_meM/praWamawaH/sarvapraWama/pUrva/SuruAwa_meM/SuruvAwa_meM/AramBa_meM/prAramBa_meM
IsavI_pUrva	IsApUrva/IsA_pUrva/IsavI_pUrva
kiMkarwwavyavimUDZa	hakkA-bakkA/BOMcakkA/kiMkarwavya-vimUDZa/kiMkarwwavya-vimUDZa/kiMkarwavyavimUDZa/kiMkarwwavyavimUDZa/hawabuxXi
anxara	aMxara/anxara/BIwara/aMxara/anxara/BIwara
ihavEM	yahIM/isI_jagaha/ihavEM
Ocaka	acAnaka/ekAeka/sahasA/ekabAragI/ikabAragI/yakAyaka/akasmAwa/akasmAw/anAyAsa/xEvAw/xEvavaSa/Ocaka/aprawyASiwawaH/ApAwawaH/aMcakEM/agawyA/acaka/acAMcaka/acAkA/acAka/acAna/anAgawaH/anyAsa/nAgahAz/AcAna/ikahAI/ikahAU/iwwiPZAkZana/iwwiPAkana/iwwaPZAkZana/iwwaPAkana/ucakA/Ocaka/acAnaka/ekAeka/sahasA/ekabAragI/ikabAragI/yakAyaka/akasmAwa/akasmAw/anAyAsa/xEvAw/xEvavaSa/Ocaka/aprawyASiwawaH/ApAwawaH/aMcakEM/agawyA/acaka/acAMcaka/acAkA/acAka/acAna/anAgawaH/anyAsa/nAgahAz/AcAna/ikahAI/ikahAU/iwwiPZAkZana/iwwiPAkana/iwwaPZAkZana/iwwaPAkana/ucakA/Ocaka
yaWecCa	icCAnusAra/icCAnukula/yaWecCa/yaWABIRta/yaWAvAMCiwa
niyamiwawaH	niyamiwawaH/niyama_se/niyamAnusAra/baxaswUra
kusamaya	kusamaya/gZalawa_vakZwa_para/asamaya/bevakZwa/galawa_vakwa_para/bevakwa/bemOke
PurwI_se	sPUrwipUrvaka/cuswI_se/PurwI_se/muswExI_se
upAyawaH	yukwipUrvaka/upAyawaH/upAya_se/jugawa_lagAkara/warakIba_se/warIkZe_se
iwWaM	yoM/yUz/Ese/isa_waraha/isa_prakAra/EsA/iwWaM/ima/imi/iBa/iva/isE/IxqS/IxqSa
avirAmawaH	lagAwAra/anavarawa/niraMwara/niranwara/wAbadZawodZa/xanAxana/sawawa/XUAzXAra/anaMwara/ananwara/avirAmawaH/aniSa/prawikRaNa/anukRaNa/XadZAXadZa/avirawa/muwwasila/avicCinna/avicCexa/aviSrAnwa/aviSrAMwa/asarAra/aharaha/AsaMga/Asafga/ikawAra
bIca-bIca_meM	samaya-samaya_para/bIca-bIca_meM
jIvanaparyanwa	Ajanma/jIvanaparyanwa/jIvanaBara
ATagunA	ATagunA/aTagunA
icCA_se	svecCApUrvaka/icCA_se/KZuSI_KZuSI/KZuSI_se/svecCayA/svecCawaH
cahuz_ora	cAroM_ora/cAroM_waraPZa/cAroM_waraPa/cahuz_ora/sarvawra/saBI_waraPZa/cAroM_xiSAoM_meM/hara_jagaha/irxa-girxa
bAkZAyaxA	viXipUrvaka/kZAyaxe_se/DaMga_se/warIkZe_se/bawOra/bAkZAyaxA/viXivaw/viXivawa
PalasvarUpa	PalasvarUpa/pariNAma_svarUpa/pariNAmasvarUpa/pariNAmawaH/PalawaH/nawIjawana
niyamAnusAra	niyamiwawaH/niyama_se/niyamAnusAra/baxaswUra/niyamAnusAra/yaWAniyama/bA-jAbwA
sABiprAyaH	uxxeSyapUrvaka/uxxeSyawaH/sABiprAyaH/soxxeSya
saMxigXawaH	aspaRtawaH/saMxigXawaH
wAbadZawodZa	lagAwAra/anavarawa/niraMwara/niranwara/wAbadZawodZa/xanAxana/sawawa/XUAzXAra/anaMwara/ananwara/avirAmawaH/aniSa/prawikRaNa/anukRaNa/XadZAXadZa/avirawa/muwwasila/avicCinna/avicCexa/aviSrAnwa/aviSrAMwa/asarAra/aharaha/AsaMga/Asafga/ikawAra
wIvra	kasakara/joraxAra/weja/wejZa/wIvra/wejZI_se/jZora_se/wejI_se/jora_se/wIvrawA_se
yukwipUrvaka	yukwipUrvaka/upAyawaH/upAya_se/jugawa_lagAkara/warakIba_se/warIkZe_se
aBI-aBI	aBI-aBI/aBI_aBI/aBI_hI/isI_vakwa/isI_kRaNa
Aswe	XIre/XIme/hOle/Ahiswe/AhiswA/Ahiswe_se/AhiswA_se/Asawe/Aswe
jZora_se	kasakara/joraxAra/weja/wejZa/wIvra/wejZI_se/jZora_se/wejI_se/jora_se/wIvrawA_se
avaSyameva	niHsaMxeha/nissaMxeha/jarUra/jZarUra/niHsanxeha/nissanxeha/nisaMxeha/nisanxeha/binA_Saka/beSaka/bilkula/bilakula/yakInana/yakZInana/avaSyameva/avaSya/alabawwA/bilASaka/aBarama/vASinxA/bASinxA/avasi/aviwarkika/asaMSaya/niSciwawaH/ikaMka
isE	yoM/yUz/Ese/isa_waraha/isa_prakAra/EsA/iwWaM/ima/imi/iBa/iva/isE/IxqS/IxqSa
navagunA	nOgunA/navagunA
BalI_BAzwi	BalI-BAzwi/BalI_BAzwi/BarapUra/BalIBAzwi/BalI-BAMwi/BalI_BAMwi/BalIBAMwi/sarvawoBAva/acCI_waraha
bAez_bAjZU	bAez/bAez_bAjZU/bAyeM
akramawaH	kramahInawaH/akramawaH/avyavasWiwawaH/jahAz_wahAz
bilAnAgA	bilAnAgA
avixUra	pAsa_meM/najZaxIka/najaxIka/nikata_meM/kZarIba_meM/samIpa/nikata/pAsa/kZarIba/karIba/sannikata/najIka/muwwasila/arvAka/avixUra/Are/AsapAsa/Asa-pAsa
haragijZa	kaxApi/haragijZa/kawaI/kawwaI
nirnimeKa	apalaka/nirnimeRa/nirnimiRa/nirnimeKa
saralawA_se	AsAnI_se/sahajawA_se/saralawA_se/Kela_Kela_meM/sahajawaH/anEse
alabawwA	niHsaMxeha/nissaMxeha/jarUra/jZarUra/niHsanxeha/nissanxeha/nisaMxeha/nisanxeha/binA_Saka/beSaka/bilkula/bilakula/yakInana/yakZInana/avaSyameva/avaSya/alabawwA/bilASaka/aBarama/vASinxA/bASinxA/avasi/aviwarkika/asaMSaya/niSciwawaH/ikaMka
rojAnA	prawixina/haraxina/niwya/hararojZa/rojZa/niwa/roja/rojZAnA/rojAnA/anuxina/niwyaprawi/anuxivasa/aharaha
paraMparAnusAra	paraMparAnusAra/baxaswUra
niHsaMkoca	nisaMkoca/niHsaMkoca/nissaMkoca/beXadZaka/saMkocahInawaH/beJiJaka/beKataka/beKatake/behicaka
uxAharaNArWa	uxAharaNArWa/uxAharaNawaH/uxAharaNa_svarUpa/masalana
agre	sAmane/Age/samakRa/sammuKa/agre/anvakRa/aBimuKa/xarapeSa/Agala/AgalA
jEse_BI_ho	jEse_ho/jEse_BI_ho
iwane_meM	iwane_meM/isa_bIca/isI_bIca/isa_xOrAna/isa_xaramyAna
pExala	pExala
kqpA_karake	kqpayA/kqpApUrvaka/kqpA_pUrvaka/kqpA_karake/meharabAnI_karake
muKyawaH	viSeRakara/KZAsakara/KZAsa_wOra_para/KZAsa_wOra_se/KZAsawOra_para/KZAsawOra_se/KAsawOra_para/KAsawOra_se/KAsakara/viSeRawaH/viSiRtawaH/muKyawaH/viSeRa_rUpa_se
acCA	TIka-TAka/TIkaTAka/TIka/acCA/baDZiyA/acCA/baDZiyA/acCI_waraha/acCI_waraha_se/tanAtana
webArA	wibArA/webArA
kaBI	kaBI/kisI_samaya
irAxawana	saMkalpapUrvaka/irAxawana/irAxe_se/xqDZawApUrvaka/niScayapUrvaka/jAna-bUJakara/jAnabUJakara/jAnabUJa_kara/amaxana/icCApUrvaka/mawipUrva/irAxawana
rawwiBara	jarA/jZarA/jarA-sA/jZarA-sA/rawwiBara/WodZA/WodZA-sA/WodZA_sA/wanika/yawkiMciw
majabUwI_se	xqDZawApUrvaka/majabUwI_se/majZabUwI_se
mawipUrva	jAna-bUJakara/jAnabUJakara/jAnabUJa_kara/amaxana/icCApUrvaka/mawipUrva/irAxawana
nirxayawA_se	nirxayawApUrvaka/nirxayawA_se/berahamI_se/bexarxI_se/krUrawApUrvaka/barbarawApUrvaka/kaTorawA_se/kadZAI_se
pacagunA	pAzcagunA/pacagunA
hOle	XIre/XIme/hOle/Ahiswe/AhiswA/Ahiswe_se/AhiswA_se/Asawe/Aswe
apekRayA	apekRAkqwa/wulanA_meM/apekRayA/mukZAbale/mukAbale/banisbawa/se
vicArapUrvaka	soca-vicArakara/samaJa-bUJakara/vicArapUrvaka/soca-samaJakara/soca_vicAra_kara/samaJa_bUJa_kara/soca_samaJa_kara/vicAriwawaH
nAKZuSI_se	aprasannawApUrvaka/nArAjZagIpUrvaka/nAKZuSI_se/nArAjagIpUrvaka/nAKuSI_se
AsO	aso/asoM/AsO/isa_varRa/isa_sAla
saMpUrNawaH	bilkula/bilakula/ekaxama/nipata/sarAsara/TIka/niwAMwa/niwAnwa/pUrNawaH/pUrI_waraha_se/pUrNawayA/saMpUrNawaH/saMpUrNawayA/pUrNarupeNa/AmUlacUla/Sawa-prawiSawa
kaba_waka	kaba_waka/kaba
pAsa-padZosa	Asa-pAsa/AsapAsa/agala-bagala/agZala-bagZala/AjU-bAjU/irxa-girxa/adZosa-padZosa/pAsa-padZosa/pAsa_padZosa
svawaMwra_rUpa_se	svAXInawaH/svawaMwra_rUpa_se
havA_kI_ora	havA_ke_anukUla/havAnukUla/havA_kI_ora/havA_kI_waraPa
xina-ba_xina	xina-prawixina/xina-xina/xina-para-xina/xina-baxina/xina-ba_xina/xinaprawixina/xinaxina/xinabaxina/xinoM-xina/xinoMxina
ciMwAhInawaH	niSciMwawaH/ciMwAhInawaH/beKatake
Jatake_ke_sAWa	Jatake_se/Jatake_ke_sAWa
tukura_tukura	takatakI_se/ekataka/tukura_tukura/taka-taka/animeRa/animiRa/animiKa/anamiKa/ikataka
havAnukUla	havA_ke_anukUla/havAnukUla/havA_kI_ora/havA_kI_waraPa
anuxivasa	prawixina/haraxina/niwya/hararojZa/rojZa/niwa/roja/rojZAnA/rojAnA/anuxina/niwyaprawi/anuxivasa/aharaha
vinayapUrvaka	namrawApUrvaka/vinayapUrvaka
Ahiswe-Ahiswe	XIre-XIre/XIre_XIre/Ahiswe-Ahiswe/AhiswA-AhiswA/hOle-hOle/hole-hole/raPwA-raPwA/alpaSaH
paraseMta	prawiSawa/PZIsaxI/PIsaxI/paraseMta
aXorXa	Upara-nIce/aXoraXa/aXorXa/aXOrxXa
saccI_muccI	vAkaI/vAkZaI/vAswava_meM/hakIkawana/hakZIkZawana/xaraasala/asala_meM/sacamuca/saccI-muccI/saccI_muccI/sawyawaH/vaswuwaH
baKErIyawa	sakuSala/kuSalawApUrvaka/kuSalapUrvaka/sahI_salAmawa/sahI-salAmawa/TIka-TAka/TIka_se/TIka-TAka_se/TIkaTAka/baKZEra/baKEra/baKZErIya/baKErIyawa/surakRiwawaH
saca-saca	saca-saca
kaBI_nahIM	kaBI_nahIM
sAWa_hI_sAWa	sAWa-sAWa/sAWa_hI/sAWa_hI_sAWa/sAWa/eka_sAWa/ikatTA/ikajora/ekawra/ikawra
anumAnawaH	aMxAjana/aMxAjZana/anxAjZana/anxAjana/lagaBaga/wakZarIbana/wakarIbana/kZarIba/karIba/karIbakarIba/karIbana/kZarIbakZarIba/kZarIbana/anumAnawaH/anakZarIba/anakarIba/waKZamInana/aMxAja_se/ukavAz
pAsa_padZosa	Asa-pAsa/AsapAsa/agala-bagala/agZala-bagZala/AjU-bAjU/irxa-girxa/adZosa-padZosa/pAsa-padZosa/pAsa_padZosa
svagawa	svagawa
bevakwa	kusamaya/gZalawa_vakZwa_para/asamaya/bevakZwa/galawa_vakwa_para/bevakwa/bemOke/asamaya/bevakZwa/bevakwa/gZalawa_samaya_para/galawa_samaya_para/bemOke
POrana	Jatapata/catapata/PatAPata/wuraMwa/wuranwa/wawkAla/avilaMba/avilamba/PZOrana/POrana/KatAka_se/wawkRaNa/wadZAka_se/wadZa_se/wapAka_se/awiSIGra/awiSIGrawaH/jalxa_se_jalxa/jalxI_se_jalxI/wadZa_se/hAWoM-hAWa/hAWoM_hAWa/hAWo-hAWa/hAWo_hAWa/Kata_se/Anana-PAnana_meM/AnanaPAnana_meM/siwAba/siwAbI/besAKwA/TahAkA/ikahAI/ikahAU
bahuwa_hI	awyaMwa/awyanwa/awyaXika/be-iMwahA/beiMwahA/bahuwa_aXika/bahuwa_hI/bepanAha/saKZwa/saKwa/jamakara/mahA/nihAyawa/cUdZAMwa/cUdZAnwa/aByaXika/Agara
saByawaH	SiRtawaH/saByawaH/bAsaUra/SAlInawaH/SiRtAcArapUrvaka/salIkZe_se
ulatA-palatA	ulatA-pulatA/ulatA_pulatA/ulatA-palatA/ultA-paltA/ultA-pultA/ultA_pultA
avera-savera	xera-savera/avera-savera
Ajakala	PilahAla/PZilahAla/aba/varwamAna_meM/Aja-kala/Ajakala/Aja_kala/AjakAla/ina_xinoM/isa_samaya/saMprawi
saccI-muccI	vAkaI/vAkZaI/vAswava_meM/hakIkawana/hakZIkZawana/xaraasala/asala_meM/sacamuca/saccI-muccI/saccI_muccI/sawyawaH/vaswuwaH
aWa	bAxa/bAxa_meM/paScAw/uparAMwa/anaMwara/paScAwa/uparAnwa/ananwara/pICe/uwwara/aWa/anupaxa/anvakRa/aBI/PZilahAla/PilahAla/isa_samaya/aba/aWa/aXunA/saMprawi/samprawi/aBU/aBE
avaSya	niHsaMxeha/nissaMxeha/jarUra/jZarUra/niHsanxeha/nissanxeha/nisaMxeha/nisanxeha/binA_Saka/beSaka/bilkula/bilakula/yakInana/yakZInana/avaSyameva/avaSya/alabawwA/bilASaka/aBarama/vASinxA/bASinxA/avasi/aviwarkika/asaMSaya/niSciwawaH/ikaMka/avaSya/jarUra/jZarUra
jugawa_lagAkara	yukwipUrvaka/upAyawaH/upAya_se/jugawa_lagAkara/warakIba_se/warIkZe_se
ultA_pultA	ulatA-pulatA/ulatA_pulatA/ulatA-palatA/ultA-paltA/ultA-pultA/ultA_pultA
xogunA	xugunA/xUnA/xogunA/xuganA/xviguNa/xviguNiwa
subaha	sabere/savere/subaha/wadZake/subaha-subaha/subaha_savere
haraxama	hameSA/saxA/niwya/saxEva/niwya_prawi/sarvaxA/sarvaWA/haraxama/haravakwa/harasamaya/xina-rAwa/xinarAwa/xina_rAwa/rAwa-xina/rAwaxina/niSixina/nisa-vAsara/nisavAsara/niSivAsara/niranwara/niraMwara/anavaXi/sarvaxEva/aharaha/pinnA/aharniSa/ahorAwra
awaH	isalie/isIlie/awaeva/awaH/lihAjA/lihAjZA
jAnabUJa_kara	jAna-bUJakara/jAnabUJakara/jAnabUJa_kara/amaxana/icCApUrvaka/mawipUrva/irAxawana
wakarIbana	aMxAjana/aMxAjZana/anxAjZana/anxAjana/lagaBaga/wakZarIbana/wakarIbana/kZarIba/karIba/karIbakarIba/karIbana/kZarIbakZarIba/kZarIbana/anumAnawaH/anakZarIba/anakarIba/waKZamInana/aMxAja_se/ukavAz
nikata_meM	pAsa_meM/najZaxIka/najaxIka/nikata_meM/kZarIba_meM/samIpa/nikata/pAsa/kZarIba/karIba/sannikata/najIka/muwwasila/arvAka/avixUra/Are/AsapAsa/Asa-pAsa
hole-hole	XIre-XIre/XIre_XIre/Ahiswe-Ahiswe/AhiswA-AhiswA/hOle-hOle/hole-hole/raPwA-raPwA/alpaSaH
paxa_prawi_paxa	kZaxama_ba_kZaxama/eka_eka_daga/paxa_prawi_paxa
asamaya	kusamaya/gZalawa_vakZwa_para/asamaya/bevakZwa/galawa_vakwa_para/bevakwa/bemOke/asamaya/bevakZwa/bevakwa/gZalawa_samaya_para/galawa_samaya_para/bemOke
jZyAxA	Upara/aXika/jyAxA/jZyAxA/bahuwa/KZUba/KUba/badZA/jyAxA/jZyAxA/aXika/kAPZI/kAPI/kadZA/jamakara/datakara
cUdZAnwa	awyaMwa/awyanwa/awyaXika/be-iMwahA/beiMwahA/bahuwa_aXika/bahuwa_hI/bepanAha/saKZwa/saKwa/jamakara/mahA/nihAyawa/cUdZAMwa/cUdZAnwa/aByaXika/Agara
yaWAkrama	kramaSaH/kramAnusAra/yaWAkrama/silasilevAra/bArI-bArI_se/kramavAra/warawIbavAra/ayugapaxa/alpaSaH
anuxina	prawixina/haraxina/niwya/hararojZa/rojZa/niwa/roja/rojZAnA/rojAnA/anuxina/niwyaprawi/anuxivasa/aharaha
avAk	cupacApa/cupa/mOna/SAMwa/SAnwa/KZAmoSI_se/KAmoSI_se/niSSabxa/avAka/avAk/bina_bole/mOnawaH
avAka	cupacApa/cupa/mOna/SAMwa/SAnwa/KZAmoSI_se/KAmoSI_se/niSSabxa/avAka/avAk/bina_bole/mOnawaH
niHsanxeha	niHsaMxeha/nissaMxeha/jarUra/jZarUra/niHsanxeha/nissanxeha/nisaMxeha/nisanxeha/binA_Saka/beSaka/bilkula/bilakula/yakInana/yakZInana/avaSyameva/avaSya/alabawwA/bilASaka/aBarama/vASinxA/bASinxA/avasi/aviwarkika/asaMSaya/niSciwawaH/ikaMka
havA_ke_anukUla	havA_ke_anukUla/havAnukUla/havA_kI_ora/havA_kI_waraPa
aXikArapUrvaka	aXikArapUrvaka/sAXikAra/aXikArawaH
iwaswawaH	iXara-uXara/jahAz-wahAz/yahAz-vahAz/iwauwa/iwaswawaH
svecCApUrvaka	svecCApUrvaka/icCA_se/KZuSI_KZuSI/KZuSI_se/svecCayA/svecCawaH
sarvopari	sarvopari
sahI_salAmawa	sakuSala/kuSalawApUrvaka/kuSalapUrvaka/sahI_salAmawa/sahI-salAmawa/TIka-TAka/TIka_se/TIka-TAka_se/TIkaTAka/baKZEra/baKEra/baKZErIya/baKErIyawa/surakRiwawaH
avyavasWiwawaH	kramahInawaH/akramawaH/avyavasWiwawaH/jahAz_wahAz
paScAw	bAxa/bAxa_meM/paScAw/uparAMwa/anaMwara/paScAwa/uparAnwa/ananwara/pICe/uwwara/aWa/anupaxa/anvakRa
xinaBara	xinaBara/pUrexina
ayAciwawaH	binamAzge/bina_mAzge/anamAzge/ayAciwawaH
AxyopAMwa	AxyopAMwa/AxyopAnwa/AxyAMwa/AxyAnwa
nalla	nalla/nalla/nalla/nalla/nalla/nalla/nalla/nalla
bilakula	niHsaMxeha/nissaMxeha/jarUra/jZarUra/niHsanxeha/nissanxeha/nisaMxeha/nisanxeha/binA_Saka/beSaka/bilkula/bilakula/yakInana/yakZInana/avaSyameva/avaSya/alabawwA/bilASaka/aBarama/vASinxA/bASinxA/avasi/aviwarkika/asaMSaya/niSciwawaH/ikaMka/bilkula/bilakula/ekaxama/nipata/sarAsara/TIka/niwAMwa/niwAnwa/pUrNawaH/pUrI_waraha_se/pUrNawayA/saMpUrNawaH/saMpUrNawayA/pUrNarupeNa/AmUlacUla/Sawa-prawiSawa
soxxeSya	uxxeSyapUrvaka/uxxeSyawaH/sABiprAyaH/soxxeSya
irAxe_se	saMkalpapUrvaka/irAxawana/irAxe_se/xqDZawApUrvaka/niScayapUrvaka
prayawna_se	prayawnapUrvaka/sAyAsa/prayawnawaH/prayawna_se
sAxeSa	AjFApUrvaka/AxeSapUrvaka/sAxeSa/AxeSa_se
PIsaxI	prawiSawa/PZIsaxI/PIsaxI/paraseMta
yahIM	yahIM/isI_jagaha/ihavEM
hAWo-hAWa	Jatapata/catapata/PatAPata/wuraMwa/wuranwa/wawkAla/avilaMba/avilamba/PZOrana/POrana/KatAka_se/wawkRaNa/wadZAka_se/wadZa_se/wapAka_se/awiSIGra/awiSIGrawaH/jalxa_se_jalxa/jalxI_se_jalxI/wadZa_se/hAWoM-hAWa/hAWoM_hAWa/hAWo-hAWa/hAWo_hAWa/Kata_se/Anana-PAnana_meM/AnanaPAnana_meM/siwAba/siwAbI/besAKwA/TahAkA/ikahAI/ikahAU
cAroM_xiSAoM_meM	cAroM_ora/cAroM_waraPZa/cAroM_waraPa/cahuz_ora/sarvawra/saBI_waraPZa/cAroM_xiSAoM_meM/hara_jagaha/irxa-girxa
SAnwipUrvaka	SAMwipUrvaka/SAnwipUrvaka
ikahAU	acAnaka/ekAeka/sahasA/ekabAragI/ikabAragI/yakAyaka/akasmAwa/akasmAw/anAyAsa/xEvAw/xEvavaSa/Ocaka/aprawyASiwawaH/ApAwawaH/aMcakEM/agawyA/acaka/acAMcaka/acAkA/acAka/acAna/anAgawaH/anyAsa/nAgahAz/AcAna/ikahAI/ikahAU/iwwiPZAkZana/iwwiPAkana/iwwaPZAkZana/iwwaPAkana/ucakA/Ocaka/Jatapata/catapata/PatAPata/wuraMwa/wuranwa/wawkAla/avilaMba/avilamba/PZOrana/POrana/KatAka_se/wawkRaNa/wadZAka_se/wadZa_se/wapAka_se/awiSIGra/awiSIGrawaH/jalxa_se_jalxa/jalxI_se_jalxI/wadZa_se/hAWoM-hAWa/hAWoM_hAWa/hAWo-hAWa/hAWo_hAWa/Kata_se/Anana-PAnana_meM/AnanaPAnana_meM/siwAba/siwAbI/besAKwA/TahAkA/ikahAI/ikahAU
Barapeta	Barapeta/petaBara
agrawaH	Age/agrawaH
TIka-TAka	TIka-TAka/TIkaTAka/TIka/acCA/baDZiyA/sakuSala/kuSalawApUrvaka/kuSalapUrvaka/sahI_salAmawa/sahI-salAmawa/TIka-TAka/TIka_se/TIka-TAka_se/TIkaTAka/baKZEra/baKEra/baKZErIya/baKErIyawa/surakRiwawaH
kAPI	bahuwa/KZUba/KUba/badZA/jyAxA/jZyAxA/aXika/kAPZI/kAPI/kadZA/jamakara/datakara/paryApwa/kAPI/kAPZI/yaWeRta/alam/alaM
ikahAI	acAnaka/ekAeka/sahasA/ekabAragI/ikabAragI/yakAyaka/akasmAwa/akasmAw/anAyAsa/xEvAw/xEvavaSa/Ocaka/aprawyASiwawaH/ApAwawaH/aMcakEM/agawyA/acaka/acAMcaka/acAkA/acAka/acAna/anAgawaH/anyAsa/nAgahAz/AcAna/ikahAI/ikahAU/iwwiPZAkZana/iwwiPAkana/iwwaPZAkZana/iwwaPAkana/ucakA/Ocaka/Jatapata/catapata/PatAPata/wuraMwa/wuranwa/wawkAla/avilaMba/avilamba/PZOrana/POrana/KatAka_se/wawkRaNa/wadZAka_se/wadZa_se/wapAka_se/awiSIGra/awiSIGrawaH/jalxa_se_jalxa/jalxI_se_jalxI/wadZa_se/hAWoM-hAWa/hAWoM_hAWa/hAWo-hAWa/hAWo_hAWa/Kata_se/Anana-PAnana_meM/AnanaPAnana_meM/siwAba/siwAbI/besAKwA/TahAkA/ikahAI/ikahAU
aBI_aBI	aBI-aBI/aBI_aBI/aBI_hI/isI_vakwa/isI_kRaNa
virAmawaH	ruka-ruka_kara/ruka-rukakara/virAmawaH/Tahara_Tahara_kara/savirAmawaH
Sawa-prawiSawa	bilkula/bilakula/ekaxama/nipata/sarAsara/TIka/niwAMwa/niwAnwa/pUrNawaH/pUrI_waraha_se/pUrNawayA/saMpUrNawaH/saMpUrNawayA/pUrNarupeNa/AmUlacUla/Sawa-prawiSawa
isI_prakAra	isI_waraha/isI_prakAra/iwWaMmeva
AxeSa_se	AjFApUrvaka/AxeSapUrvaka/sAxeSa/AxeSa_se
baDZAcaDZAkara	baDZA-caDZAkara/baDZAcaDZAkara
iwimAwra	iwanA_hI/iwimAwra
AjakAla	PilahAla/PZilahAla/aba/varwamAna_meM/Aja-kala/Ajakala/Aja_kala/AjakAla/ina_xinoM/isa_samaya/saMprawi
AsAnI_se	AsAnI_se/sahajawA_se/saralawA_se/Kela_Kela_meM/sahajawaH/anEse
cAroM_ora	cAroM_ora/cAroM_waraPZa/cAroM_waraPa/cahuz_ora/sarvawra/saBI_waraPZa/cAroM_xiSAoM_meM/hara_jagaha/irxa-girxa
wanahA	akelA/akele/kevala/sirPZa/mAwra/KAlI/KZAlI/basa/nipata/mahajZa/sirPa/wanhA/wanahA/ekAkI/ekameva/ekaMga/ikelA
TaMde_TaMde	TaMde-TaMde/TaMde_TaMde/TaMDe-TaMDe/TaMDe_TaMDe
aXikawaH	aXikawaH/aXikAMSawaH/prAyaH/aXikAMSawayA
prayawnahInawaH	anAyAsa/binA_pariSrama/aprayawnawaH/prayawnahInawaH/ayAsa
wuranwa	Jatapata/catapata/PatAPata/wuraMwa/wuranwa/wawkAla/avilaMba/avilamba/PZOrana/POrana/KatAka_se/wawkRaNa/wadZAka_se/wadZa_se/wapAka_se/awiSIGra/awiSIGrawaH/jalxa_se_jalxa/jalxI_se_jalxI/wadZa_se/hAWoM-hAWa/hAWoM_hAWa/hAWo-hAWa/hAWo_hAWa/Kata_se/Anana-PAnana_meM/AnanaPAnana_meM/siwAba/siwAbI/besAKwA/TahAkA/ikahAI/ikahAU
IrRyApUrvaka	IrRyApUrvaka/IrRyawaH/xveRapUrvaka/sAsUya/IrRyApUrNawaH
CaHgunA	CahagunA/COgunA/CaHgunA
iwauwa	iXara-uXara/jahAz-wahAz/yahAz-vahAz/iwauwa/iwaswawaH
acaka	acAnaka/ekAeka/sahasA/ekabAragI/ikabAragI/yakAyaka/akasmAwa/akasmAw/anAyAsa/xEvAw/xEvavaSa/Ocaka/aprawyASiwawaH/ApAwawaH/aMcakEM/agawyA/acaka/acAMcaka/acAkA/acAka/acAna/anAgawaH/anyAsa/nAgahAz/AcAna/ikahAI/ikahAU/iwwiPZAkZana/iwwiPAkana/iwwaPZAkZana/iwwaPAkana/ucakA/Ocaka
prayawnapUrvaka	prayawnapUrvaka/sAyAsa/prayawnawaH/prayawna_se
kala	kala/kAlha/kala
aBisWira	aBisWira
wadZAka_se	Jatapata/catapata/PatAPata/wuraMwa/wuranwa/wawkAla/avilaMba/avilamba/PZOrana/POrana/KatAka_se/wawkRaNa/wadZAka_se/wadZa_se/wapAka_se/awiSIGra/awiSIGrawaH/jalxa_se_jalxa/jalxI_se_jalxI/wadZa_se/hAWoM-hAWa/hAWoM_hAWa/hAWo-hAWa/hAWo_hAWa/Kata_se/Anana-PAnana_meM/AnanaPAnana_meM/siwAba/siwAbI/besAKwA/TahAkA/ikahAI/ikahAU/wadZa_se/wadZAka_se
hUbahU	prawirUpawaH/hUbahU/hU-ba-hU
hameSA_kI_waraha	hasbemAmUla/hasbe-mAmUla/hasba-e-mAmUla/hameSA_kI_waraha
xayApUrvaka	xayApUrvaka/kqpA_kara_ke/kqpApUrvaka/xayA_se/barAe_meharabAnI
jahAz	jahAz
xerI_se	vilaMbawaH/aSIGrawaH/xerI_se/vilaMbapUrvaka/xera_meM
UzcAI_para	Upara/UzcAI_para/UrxXva/UrXva
kisI_samaya	kaBI/kisI_samaya
apalaka	apalaka/nirnimeRa/nirnimiRa/nirnimeKa
kAraNavaSa	kAraNavaSa/kAraNawaH
Asafga	lagAwAra/anavarawa/niraMwara/niranwara/wAbadZawodZa/xanAxana/sawawa/XUAzXAra/anaMwara/ananwara/avirAmawaH/aniSa/prawikRaNa/anukRaNa/XadZAXadZa/avirawa/muwwasila/avicCinna/avicCexa/aviSrAnwa/aviSrAMwa/asarAra/aharaha/AsaMga/Asafga/ikawAra
aMwa_meM	aMwawaH/aMwawogawvA/aMwa_meM/AKira/AKZira/AKZirakAra/AKirakAra/howe_havAwe
waxananwara	wawapaScAwa/waxanaMwara/waxauparAMwa/waxoparAMwa/waxaMwara/waxananwara/waxuparAMwa/waxuparAnwa/waxoparAMwa/waxoparAnwa/waxanwara
svawaH	svayaM/svawaH/Kuxa/KZuxa/Apa/ApahI/apaneApa/KZuxa_hI/sAkRAw/sAkRAwa/asAlawana/AparUpa/svawaH/apaneApa/KZuxa-ba-KZuxa/KZuxabaKZuxa/Kuxa-ba-Kuxa/KuxabaKuxa
Are	pAsa_meM/najZaxIka/najaxIka/nikata_meM/kZarIba_meM/samIpa/nikata/pAsa/kZarIba/karIba/sannikata/najIka/muwwasila/arvAka/avixUra/Are/AsapAsa/Asa-pAsa
muAPZikZa	anusAra/mAPika/muwAbika/anukUla/muAPZikZa/muAPika/muwAbikZa/aprawIRa
viXivawa	viXipUrvaka/kZAyaxe_se/DaMga_se/warIkZe_se/bawOra/bAkZAyaxA/viXivaw/viXivawa
hakZIkZawana	vAkaI/vAkZaI/vAswava_meM/hakIkawana/hakZIkZawana/xaraasala/asala_meM/sacamuca/saccI-muccI/saccI_muccI/sawyawaH/vaswuwaH
xera_meM	vilaMbawaH/aSIGrawaH/xerI_se/vilaMbapUrvaka/xera_meM
karInAvAra	warIkZe_se/warIke_se/warawIba_se/kZarIne_se/karIne_se/vyavasWApUrvaka/vyavasWiwawaH/kZarInAvAra/karInAvAra
besoce_samaJe	vicArahInawaH/anasoce/besoce_samaJe
cAragunA	cOgunA/cAra_gunA/cAragunA/cawurguNa
soca_samaJa_kara	soca-vicArakara/samaJa-bUJakara/vicArapUrvaka/soca-samaJakara/soca_vicAra_kara/samaJa_bUJa_kara/soca_samaJa_kara/vicAriwawaH
bewarIkZe	viXihInawaH/kuviXipUrvaka/bewarIkZe
hara_kRaNa	prawikRaNa/pala_pala/pala-pala/prawipala/hara_kRaNa/kRaNa-kRaNa/haraGadZI/hara_GadZI/prawi_kRaNa/kRaNakRaNa/anukRaNa/CinaCina/Cina-Cina/AKana
awIwa_meM	awIwa_meM/pahale/BUwa_meM/BUwa_kAla_meM/pICe/piCale_xinoM_meM
aBimAna_se	aBimAnapUrvaka/aBimAna_se/sagarva/sABimAna
AxyAnwa	AxyopAMwa/AxyopAnwa/AxyAMwa/AxyAnwa
bAijZjZawa	bAijjawa/bAijZjZawa/sasammAna
xinoM-xina	xina-prawixina/xina-xina/xina-para-xina/xina-baxina/xina-ba_xina/xinaprawixina/xinaxina/xinabaxina/xinoM-xina/xinoMxina
teDZA	wiraCA/wiryaka/AdZA/teDZA/bAzkA/wirapata
anekaSaH	kaI_bAra/bahuwa_bAra/anekaSaH
kaTinAI_se	kaTinAI_se/jEse_wEse/muSkila_se/bamuSkila/kaTinawaH/nITi
bIcobIca	bIcobIca/bIcoMbIca/bIcoM-bIca/bIcama_bIca/bIcoM_bIca
acAka	acAnaka/ekAeka/sahasA/ekabAragI/ikabAragI/yakAyaka/akasmAwa/akasmAw/anAyAsa/xEvAw/xEvavaSa/Ocaka/aprawyASiwawaH/ApAwawaH/aMcakEM/agawyA/acaka/acAMcaka/acAkA/acAka/acAna/anAgawaH/anyAsa/nAgahAz/AcAna/ikahAI/ikahAU/iwwiPZAkZana/iwwiPAkana/iwwaPZAkZana/iwwaPAkana/ucakA/Ocaka
siwAba	Jatapata/catapata/PatAPata/wuraMwa/wuranwa/wawkAla/avilaMba/avilamba/PZOrana/POrana/KatAka_se/wawkRaNa/wadZAka_se/wadZa_se/wapAka_se/awiSIGra/awiSIGrawaH/jalxa_se_jalxa/jalxI_se_jalxI/wadZa_se/hAWoM-hAWa/hAWoM_hAWa/hAWo-hAWa/hAWo_hAWa/Kata_se/Anana-PAnana_meM/AnanaPAnana_meM/siwAba/siwAbI/besAKwA/TahAkA/ikahAI/ikahAU
isI_kAraNa	waBI/isI_kAraNa
burA	burA/KarAba/burI_waraha
usI_GadZI	waBI/waba_hI/usI_samaya/usI_GadZI
rojZa	prawixina/haraxina/niwya/hararojZa/rojZa/niwa/roja/rojZAnA/rojAnA/anuxina/niwyaprawi/anuxivasa/aharaha
be-iMwahA	awyaMwa/awyanwa/awyaXika/be-iMwahA/beiMwahA/bahuwa_aXika/bahuwa_hI/bepanAha/saKZwa/saKwa/jamakara/mahA/nihAyawa/cUdZAMwa/cUdZAnwa/aByaXika/Agara
Barose	Barose/mAWe
saxA	hameSA/saxA/niwya/saxEva/niwya_prawi/sarvaxA/sarvaWA/haraxama/haravakwa/harasamaya/xina-rAwa/xinarAwa/xina_rAwa/rAwa-xina/rAwaxina/niSixina/nisa-vAsara/nisavAsara/niSivAsara/niranwara/niraMwara/anavaXi/sarvaxEva/aharaha/pinnA/aharniSa/ahorAwra
iwWe	iXara/isa_ora/yahAz_para/iwaH/iwa/iwE/iwWe
acAkA	acAnaka/ekAeka/sahasA/ekabAragI/ikabAragI/yakAyaka/akasmAwa/akasmAw/anAyAsa/xEvAw/xEvavaSa/Ocaka/aprawyASiwawaH/ApAwawaH/aMcakEM/agawyA/acaka/acAMcaka/acAkA/acAka/acAna/anAgawaH/anyAsa/nAgahAz/AcAna/ikahAI/ikahAU/iwwiPZAkZana/iwwiPAkana/iwwaPZAkZana/iwwaPAkana/ucakA/Ocaka
jahAz-wahAz	iXara-uXara/jahAz-wahAz/yahAz-vahAz/iwauwa/iwaswawaH
bArIkI_se	bArIkZI_se/bArIkI_se/sUkRmawaH
kAraNa_se	prayojanawaH/kAma_se/kAraNa_se/saprayojana
nAgahAz	acAnaka/ekAeka/sahasA/ekabAragI/ikabAragI/yakAyaka/akasmAwa/akasmAw/anAyAsa/xEvAw/xEvavaSa/Ocaka/aprawyASiwawaH/ApAwawaH/aMcakEM/agawyA/acaka/acAMcaka/acAkA/acAka/acAna/anAgawaH/anyAsa/nAgahAz/AcAna/ikahAI/ikahAU/iwwiPZAkZana/iwwiPAkana/iwwaPZAkZana/iwwaPAkana/ucakA/Ocaka
TIkaTAka	TIka-TAka/TIkaTAka/TIka/acCA/baDZiyA/sakuSala/kuSalawApUrvaka/kuSalapUrvaka/sahI_salAmawa/sahI-salAmawa/TIka-TAka/TIka_se/TIka-TAka_se/TIkaTAka/baKZEra/baKEra/baKZErIya/baKErIyawa/surakRiwawaH
vaswuwaH	vAkaI/vAkZaI/vAswava_meM/hakIkawana/hakZIkZawana/xaraasala/asala_meM/sacamuca/saccI-muccI/saccI_muccI/sawyawaH/vaswuwaH
pqRTawaH	pICe/paScawaH/pACe/pqRTawaH/arvAka
anAyAsa	acAnaka/ekAeka/sahasA/ekabAragI/ikabAragI/yakAyaka/akasmAwa/akasmAw/anAyAsa/xEvAw/xEvavaSa/Ocaka/aprawyASiwawaH/ApAwawaH/aMcakEM/agawyA/acaka/acAMcaka/acAkA/acAka/acAna/anAgawaH/anyAsa/nAgahAz/AcAna/ikahAI/ikahAU/iwwiPZAkZana/iwwiPAkana/iwwaPZAkZana/iwwaPAkana/ucakA/Ocaka/anAyAsa/binA_pariSrama/aprayawnawaH/prayawnahInawaH/ayAsa
bexarxI_se	nirxayawApUrvaka/nirxayawA_se/berahamI_se/bexarxI_se/krUrawApUrvaka/barbarawApUrvaka/kaTorawA_se/kadZAI_se
Aja_kala	PilahAla/PZilahAla/aba/varwamAna_meM/Aja-kala/Ajakala/Aja_kala/AjakAla/ina_xinoM/isa_samaya/saMprawi
pUrNawayA	bilkula/bilakula/ekaxama/nipata/sarAsara/TIka/niwAMwa/niwAnwa/pUrNawaH/pUrI_waraha_se/pUrNawayA/saMpUrNawaH/saMpUrNawayA/pUrNarupeNa/AmUlacUla/Sawa-prawiSawa
AramBa_meM	AraMBa_meM/AraMBawaH/AramBawaH/pahale/SurU_meM/praWama/Axi_meM/praWamawaH/sarvapraWama/pUrva/SuruAwa_meM/SuruvAwa_meM/AramBa_meM/prAramBa_meM
KAsawOra_se	viSeRakara/KZAsakara/KZAsa_wOra_para/KZAsa_wOra_se/KZAsawOra_para/KZAsawOra_se/KAsawOra_para/KAsawOra_se/KAsakara/viSeRawaH/viSiRtawaH/muKyawaH/viSeRa_rUpa_se
pahale_pahala	pahale_pahala/praWamawaH/sarva_praWama/sarvapraWama/SurU_meM/pahale-pahala/avvalana/pahile_pahala/pahile_pahala
AKira	aMwawaH/aMwawogawvA/aMwa_meM/AKira/AKZira/AKZirakAra/AKirakAra/howe_havAwe
harasamaya	hameSA/saxA/niwya/saxEva/niwya_prawi/sarvaxA/sarvaWA/haraxama/haravakwa/harasamaya/xina-rAwa/xinarAwa/xina_rAwa/rAwa-xina/rAwaxina/niSixina/nisa-vAsara/nisavAsara/niSivAsara/niranwara/niraMwara/anavaXi/sarvaxEva/aharaha/pinnA/aharniSa/ahorAwra
soca-samaJakara	soca-vicArakara/samaJa-bUJakara/vicArapUrvaka/soca-samaJakara/soca_vicAra_kara/samaJa_bUJa_kara/soca_samaJa_kara/vicAriwawaH
KarAba	burA/KarAba/burI_waraha
animiwwa	akAraNa/bemawalaba/niRkAraNa/kAraNahInawaH/animiwwa
niSciwawaH	niHsaMxeha/nissaMxeha/jarUra/jZarUra/niHsanxeha/nissanxeha/nisaMxeha/nisanxeha/binA_Saka/beSaka/bilkula/bilakula/yakInana/yakZInana/avaSyameva/avaSya/alabawwA/bilASaka/aBarama/vASinxA/bASinxA/avasi/aviwarkika/asaMSaya/niSciwawaH/ikaMka
kaBI-kaBAra	kaBIkaBI/kaBIkaBAra/yaxAkaxA/kaBI-kaBI/kaBI-kaBAra/yaxA-kaxA/vakwan-POvakwan
aprawyASiwawaH	acAnaka/ekAeka/sahasA/ekabAragI/ikabAragI/yakAyaka/akasmAwa/akasmAw/anAyAsa/xEvAw/xEvavaSa/Ocaka/aprawyASiwawaH/ApAwawaH/aMcakEM/agawyA/acaka/acAMcaka/acAkA/acAka/acAna/anAgawaH/anyAsa/nAgahAz/AcAna/ikahAI/ikahAU/iwwiPZAkZana/iwwiPAkana/iwwaPZAkZana/iwwaPAkana/ucakA/Ocaka
pinnA	hameSA/saxA/niwya/saxEva/niwya_prawi/sarvaxA/sarvaWA/haraxama/haravakwa/harasamaya/xina-rAwa/xinarAwa/xina_rAwa/rAwa-xina/rAwaxina/niSixina/nisa-vAsara/nisavAsara/niSivAsara/niranwara/niraMwara/anavaXi/sarvaxEva/aharaha/pinnA/aharniSa/ahorAwra
sAmAnyawaH	sAmAnyawaH/sAmAnyawayA/sAXAraNawaH/sAXAraNawayA/amUmana/umUmana
IxqSa	yoM/yUz/Ese/isa_waraha/isa_prakAra/EsA/iwWaM/ima/imi/iBa/iva/isE/IxqS/IxqSa
asarAra	lagAwAra/anavarawa/niraMwara/niranwara/wAbadZawodZa/xanAxana/sawawa/XUAzXAra/anaMwara/ananwara/avirAmawaH/aniSa/prawikRaNa/anukRaNa/XadZAXadZa/avirawa/muwwasila/avicCinna/avicCexa/aviSrAnwa/aviSrAMwa/asarAra/aharaha/AsaMga/Asafga/ikawAra
PZajZUla	vyarWa_hI/yoM_hI/JUTa-mUTa/yOM_hI/yUz_hI/Ese_hI/nAhakZa/nAhaka/PZajZUla/PajUla/PZijZUla/PijUla/anahaka/anAhaka
jEsA	jEsA/jEse/jisa_prakAra/jisa_prakAra_se
Axara_sahiwa	sawkArapUrvaka/sAxara/sasammAna/Axara_sahiwa
alpawaH	alpawaH/WodZA-WodZA/WodZA_WodZA/alpaSaH
jora-Sora_se	jZora-Sora_se/jora-Sora_se/jZoraSora_se/joraSora_se/jZoroM_se/joroM_se
yaxAkaxA	kaBIkaBI/kaBIkaBAra/yaxAkaxA/kaBI-kaBI/kaBI-kaBAra/yaxA-kaxA/vakwan-POvakwan
hAWoM_hAWa	Jatapata/catapata/PatAPata/wuraMwa/wuranwa/wawkAla/avilaMba/avilamba/PZOrana/POrana/KatAka_se/wawkRaNa/wadZAka_se/wadZa_se/wapAka_se/awiSIGra/awiSIGrawaH/jalxa_se_jalxa/jalxI_se_jalxI/wadZa_se/hAWoM-hAWa/hAWoM_hAWa/hAWo-hAWa/hAWo_hAWa/Kata_se/Anana-PAnana_meM/AnanaPAnana_meM/siwAba/siwAbI/besAKwA/TahAkA/ikahAI/ikahAU
jEse	jEsA/jEse/jisa_prakAra/jisa_prakAra_se
ekataka	takatakI_se/ekataka/tukura_tukura/taka-taka/animeRa/animiRa/animiKa/anamiKa/ikataka
aSIGrawaH	vilaMbawaH/aSIGrawaH/xerI_se/vilaMbapUrvaka/xera_meM
pUrA	pUrA/pUrI_waraha
xasagunA	xasagunA/xaSagunA/xasa_gunA/xaSa_gunA
maraNoparAMwa	maraNoparAMwa/maraNoparAnwa
yaWAkarma	yaWAkarma/karmAnusAra
labarejZa	labAlaba/labareja/labarejZa
avicCexa	lagAwAra/anavarawa/niraMwara/niranwara/wAbadZawodZa/xanAxana/sawawa/XUAzXAra/anaMwara/ananwara/avirAmawaH/aniSa/prawikRaNa/anukRaNa/XadZAXadZa/avirawa/muwwasila/avicCinna/avicCexa/aviSrAnwa/aviSrAMwa/asarAra/aharaha/AsaMga/Asafga/ikawAra
badZA	bahuwa/KZUba/KUba/badZA/jyAxA/jZyAxA/aXika/kAPZI/kAPI/kadZA/jamakara/datakara
ciMwiwawaH	ciMwiwawaH/uxvignawaH/uxvignawApUrvaka
svAXInawaH	svAXInawaH/svawaMwra_rUpa_se
jEse_ho	jEse_ho/jEse_BI_ho
uxAharaNa_svarUpa	uxAharaNArWa/uxAharaNawaH/uxAharaNa_svarUpa/masalana
kuCa	kuCa
Ajawaka	aba_waka/aBI_waka/Aja_waka/abawaka/aBIwaka/Ajawaka/ajahuz/ajahUz/ajo/ajOM/abalaga
AparUpa	svayaM/svawaH/Kuxa/KZuxa/Apa/ApahI/apaneApa/KZuxa_hI/sAkRAw/sAkRAwa/asAlawana/AparUpa
usa_ora	uXara/usa_ora/pare/uwa/uwana
KZuxa-ba-KZuxa	svawaH/apaneApa/KZuxa-ba-KZuxa/KZuxabaKZuxa/Kuxa-ba-Kuxa/KuxabaKuxa
wawapaScAwa	wawapaScAwa/waxanaMwara/waxauparAMwa/waxoparAMwa/waxaMwara/waxananwara/waxuparAMwa/waxuparAnwa/waxoparAMwa/waxoparAnwa/waxanwara
hAWa_se	hAWa_se/hAWa_xvArA/haswacAliwa_DaMga_se/haswacAlana_xvArA
ekAeka	acAnaka/ekAeka/sahasA/ekabAragI/ikabAragI/yakAyaka/akasmAwa/akasmAw/anAyAsa/xEvAw/xEvavaSa/Ocaka/aprawyASiwawaH/ApAwawaH/aMcakEM/agawyA/acaka/acAMcaka/acAkA/acAka/acAna/anAgawaH/anyAsa/nAgahAz/AcAna/ikahAI/ikahAU/iwwiPZAkZana/iwwiPAkana/iwwaPZAkZana/iwwaPAkana/ucakA/Ocaka
waxuparAMwa	wawapaScAwa/waxanaMwara/waxauparAMwa/waxoparAMwa/waxaMwara/waxananwara/waxuparAMwa/waxuparAnwa/waxoparAMwa/waxoparAnwa/waxanwara
ajahUz	aba_waka/aBI_waka/Aja_waka/abawaka/aBIwaka/Ajawaka/ajahuz/ajahUz/ajo/ajOM/abalaga
sawyawaH	vAkaI/vAkZaI/vAswava_meM/hakIkawana/hakZIkZawana/xaraasala/asala_meM/sacamuca/saccI-muccI/saccI_muccI/sawyawaH/vaswuwaH
bahuwa	bahuwa/KZUba/KUba/badZA/jyAxA/jZyAxA/aXika/kAPZI/kAPI/kadZA/jamakara/datakara
wiryaka	wiraCA/wiryaka/AdZA/teDZA/bAzkA/wirapata
aMwawaH	aMwawaH/aMwawogawvA/aMwa_meM/AKira/AKZira/AKZirakAra/AKirakAra/howe_havAwe
mahA	awyaMwa/awyanwa/awyaXika/be-iMwahA/beiMwahA/bahuwa_aXika/bahuwa_hI/bepanAha/saKZwa/saKwa/jamakara/mahA/nihAyawa/cUdZAMwa/cUdZAnwa/aByaXika/Agara
asaMSaya	niHsaMxeha/nissaMxeha/jarUra/jZarUra/niHsanxeha/nissanxeha/nisaMxeha/nisanxeha/binA_Saka/beSaka/bilkula/bilakula/yakInana/yakZInana/avaSyameva/avaSya/alabawwA/bilASaka/aBarama/vASinxA/bASinxA/avasi/aviwarkika/asaMSaya/niSciwawaH/ikaMka
bAez	bAez/bAez_bAjZU/bAyeM
anukUla	anusAra/mAPika/muwAbika/anukUla/muAPZikZa/muAPika/muwAbikZa/aprawIRa
aXunA	aBI/PZilahAla/PilahAla/isa_samaya/aba/aWa/aXunA/saMprawi/samprawi/aBU/aBE
aXInawA_meM	parAXInawaH/aXInawA_meM/paravaSawaH
prawivarRa	harasAla/prawivarRa/xarasAla/anuvawsara
marNowwara	marNowwara
nimnawaH	nIce/aXaH/nimnawaH/aXo_xiSA_meM
kZiswa_xara_kZiswa	kZiswavAra/kiswavAra/kZiswa_xara_kZiswa/kZiswoM_meM
jalxI	jalxI/SIGra/SIGrawaH/avilaMbawaH/jalxa/acira/wUrNa/SiwAba/begi/avalaMbiwa/avalambiwa/jalxI_se/ASu/avilaMbiwa/avilambiwa/jalxI/savere/sabere
uparAnwa	bAxa/bAxa_meM/paScAw/uparAMwa/anaMwara/paScAwa/uparAnwa/ananwara/pICe/uwwara/aWa/anupaxa/anvakRa
kaBI_na_kaBI	xera-savera/kaBI_na_kaBI
havA_kI_waraPa	havA_ke_anukUla/havAnukUla/havA_kI_ora/havA_kI_waraPa
jalxa	jalxI/SIGra/SIGrawaH/avilaMbawaH/jalxa/acira/wUrNa/SiwAba/begi/avalaMbiwa/avalambiwa/jalxI_se/ASu/avilaMbiwa/avilambiwa
niruxxeSyawaH	uxxeSyahInawaH/niruxxeSya/niruxxeSyawaH
binA_Saka	niHsaMxeha/nissaMxeha/jarUra/jZarUra/niHsanxeha/nissanxeha/nisaMxeha/nisanxeha/binA_Saka/beSaka/bilkula/bilakula/yakInana/yakZInana/avaSyameva/avaSya/alabawwA/bilASaka/aBarama/vASinxA/bASinxA/avasi/aviwarkika/asaMSaya/niSciwawaH/ikaMka
vakwan-POvakwan	kaBIkaBI/kaBIkaBAra/yaxAkaxA/kaBI-kaBI/kaBI-kaBAra/yaxA-kaxA/vakwan-POvakwan
waxoparAnwa	wawapaScAwa/waxanaMwara/waxauparAMwa/waxoparAMwa/waxaMwara/waxananwara/waxuparAMwa/waxuparAnwa/waxoparAMwa/waxoparAnwa/waxanwara
kahe_muwAbika	kaWanAnusAra/kahanAnusAra/kahe_muwAbika/kahe_muwAbikZa/kahe_anusAra
Age	sAmane/Age/samakRa/sammuKa/agre/anvakRa/aBimuKa/xarapeSa/Agala/AgalA/Age/agrawaH/BaviRya_meM/Age/BaviRya_kAla_meM/agawyA/pare/Age/bAxa/aba/Age/AinxA/AiMxA/AyaMxA/AyanxA
ekaxama	bilkula/bilakula/ekaxama/nipata/sarAsara/TIka/niwAMwa/niwAnwa/pUrNawaH/pUrI_waraha_se/pUrNawayA/saMpUrNawaH/saMpUrNawayA/pUrNarupeNa/AmUlacUla/Sawa-prawiSawa
KZuxa	svayaM/svawaH/Kuxa/KZuxa/Apa/ApahI/apaneApa/KZuxa_hI/sAkRAw/sAkRAwa/asAlawana/AparUpa
Cama-Cama	CamaCama/Cama-Cama
isI_jagaha	yahIM/isI_jagaha/ihavEM
vyarWa_hI	vyarWa_hI/yoM_hI/JUTa-mUTa/yOM_hI/yUz_hI/Ese_hI/nAhakZa/nAhaka/PZajZUla/PajUla/PZijZUla/PijUla/anahaka/anAhaka
viSvAsa_ke_sAWa	viSvAsa_ke_sAWa/viSvasanIyawA_se/viSvAsapUrvaka
KacAKaca	TasATasa/TuzsATuzsa/KacAKaca/TusATusa
AmUla	AmUla
nirnimiRa	apalaka/nirnimeRa/nirnimiRa/nirnimeKa
utakkara	aMXAXuMXa/bewahASA/anXAXunXa/aMXaXuMXa/anXaXunXa/utakkara
gahare	gahare/gaharAI_meM
jyoM_kA_wyoM	jyoM_kA_wyoM/jEse_kA_wEse
sAkRAwa	svayaM/svawaH/Kuxa/KZuxa/Apa/ApahI/apaneApa/KZuxa_hI/sAkRAw/sAkRAwa/asAlawana/AparUpa
wawkRaNa	Jatapata/catapata/PatAPata/wuraMwa/wuranwa/wawkAla/avilaMba/avilamba/PZOrana/POrana/KatAka_se/wawkRaNa/wadZAka_se/wadZa_se/wapAka_se/awiSIGra/awiSIGrawaH/jalxa_se_jalxa/jalxI_se_jalxI/wadZa_se/hAWoM-hAWa/hAWoM_hAWa/hAWo-hAWa/hAWo_hAWa/Kata_se/Anana-PAnana_meM/AnanaPAnana_meM/siwAba/siwAbI/besAKwA/TahAkA/ikahAI/ikahAU
uxvignawaH	ciMwiwawaH/uxvignawaH/uxvignawApUrvaka
xina_rAwa	hameSA/saxA/niwya/saxEva/niwya_prawi/sarvaxA/sarvaWA/haraxama/haravakwa/harasamaya/xina-rAwa/xinarAwa/xina_rAwa/rAwa-xina/rAwaxina/niSixina/nisa-vAsara/nisavAsara/niSivAsara/niranwara/niraMwara/anavaXi/sarvaxEva/aharaha/pinnA/aharniSa/ahorAwra
kyUzkara	kyoMkara/kyUzkara/kEse
pICe	pICe/paScawaH/pACe/pqRTawaH/arvAka/bAxa/bAxa_meM/paScAw/uparAMwa/anaMwara/paScAwa/uparAnwa/ananwara/pICe/uwwara/aWa/anupaxa/anvakRa/awIwa_meM/pahale/BUwa_meM/BUwa_kAla_meM/pICe/piCale_xinoM_meM
samewa	sahiwa/samewa
bevajaha	akAraNa/prayojanahInawaH/Ese_hI/yUz_hI/kAraNahInawaH/bevajaha/uxxeSyahInawaH
pUrvavaw	pUrvavaw/pUrvavawa
paravaSawaH	parAXInawaH/aXInawA_meM/paravaSawaH
lihAjZA	isalie/isIlie/awaeva/awaH/lihAjA/lihAjZA
xaraasala	vAkaI/vAkZaI/vAswava_meM/hakIkawana/hakZIkZawana/xaraasala/asala_meM/sacamuca/saccI-muccI/saccI_muccI/sawyawaH/vaswuwaH
kalyANArWa	hiwArWa/kalyANArWa
wulanA_meM	apekRAkqwa/wulanA_meM/apekRayA/mukZAbale/mukAbale/banisbawa/se
spaRtawaH	spaRta/spaRtawaH/Kula_kara/Kule_wOra_para/Kullama_KullA/binA_lAga_lapeta_ke/sAPZa_sAPZa/spaRtawayA/sAPZa-sAPZa/sAPa-sAPa
awarasoM	narasoM/awarasoM/warasoM/narasoM/awarasoM/warasoM
ukavAz	aMxAjana/aMxAjZana/anxAjZana/anxAjana/lagaBaga/wakZarIbana/wakarIbana/kZarIba/karIba/karIbakarIba/karIbana/kZarIbakZarIba/kZarIbana/anumAnawaH/anakZarIba/anakarIba/waKZamInana/aMxAja_se/ukavAz
saKwa	awyaMwa/awyanwa/awyaXika/be-iMwahA/beiMwahA/bahuwa_aXika/bahuwa_hI/bepanAha/saKZwa/saKwa/jamakara/mahA/nihAyawa/cUdZAMwa/cUdZAnwa/aByaXika/Agara
AcAna	acAnaka/ekAeka/sahasA/ekabAragI/ikabAragI/yakAyaka/akasmAwa/akasmAw/anAyAsa/xEvAw/xEvavaSa/Ocaka/aprawyASiwawaH/ApAwawaH/aMcakEM/agawyA/acaka/acAMcaka/acAkA/acAka/acAna/anAgawaH/anyAsa/nAgahAz/AcAna/ikahAI/ikahAU/iwwiPZAkZana/iwwiPAkana/iwwaPZAkZana/iwwaPAkana/ucakA/Ocaka
pariNAma_svarUpa	PalasvarUpa/pariNAma_svarUpa/pariNAmasvarUpa/pariNAmawaH/PalawaH/nawIjawana
sare-Ama	KuleAma/Kulakara/sareAma/sare-Ama/Kule-Ama/Kullama-KullA/KullamaKullA/daMke_kI_cota_para/sare_Ama/agupwawaH
silasilevAra	kramaSaH/kramAnusAra/yaWAkrama/silasilevAra/bArI-bArI_se/kramavAra/warawIbavAra/ayugapaxa/alpaSaH
galawa_samaya_para	asamaya/bevakZwa/bevakwa/gZalawa_samaya_para/galawa_samaya_para/bemOke
UrXva	Upara/UzcAI_para/UrxXva/UrXva
waba_waka	waba_waka
begi	jalxI/SIGra/SIGrawaH/avilaMbawaH/jalxa/acira/wUrNa/SiwAba/begi/avalaMbiwa/avalambiwa/jalxI_se/ASu/avilaMbiwa/avilambiwa
KAlI	akelA/akele/kevala/sirPZa/mAwra/KAlI/KZAlI/basa/nipata/mahajZa/sirPa/wanhA/wanahA/ekAkI/ekameva/ekaMga/ikelA
lihAjA	isalie/isIlie/awaeva/awaH/lihAjA/lihAjZA
ekabAragI	acAnaka/ekAeka/sahasA/ekabAragI/ikabAragI/yakAyaka/akasmAwa/akasmAw/anAyAsa/xEvAw/xEvavaSa/Ocaka/aprawyASiwawaH/ApAwawaH/aMcakEM/agawyA/acaka/acAMcaka/acAkA/acAka/acAna/anAgawaH/anyAsa/nAgahAz/AcAna/ikahAI/ikahAU/iwwiPZAkZana/iwwiPAkana/iwwaPZAkZana/iwwaPAkana/ucakA/Ocaka
XIre-XIre	XIre-XIre/XIre_XIre/Ahiswe-Ahiswe/AhiswA-AhiswA/hOle-hOle/hole-hole/raPwA-raPwA/alpaSaH
siwAbI	Jatapata/catapata/PatAPata/wuraMwa/wuranwa/wawkAla/avilaMba/avilamba/PZOrana/POrana/KatAka_se/wawkRaNa/wadZAka_se/wadZa_se/wapAka_se/awiSIGra/awiSIGrawaH/jalxa_se_jalxa/jalxI_se_jalxI/wadZa_se/hAWoM-hAWa/hAWoM_hAWa/hAWo-hAWa/hAWo_hAWa/Kata_se/Anana-PAnana_meM/AnanaPAnana_meM/siwAba/siwAbI/besAKwA/TahAkA/ikahAI/ikahAU
TaMDe-TaMDe	TaMde-TaMde/TaMde_TaMde/TaMDe-TaMDe/TaMDe_TaMDe
yaWAsWAna	yaWAsWAna
PZajUla	vyarWa/PZajUla/PijUla/PZijUla/anerA/yoM_hI/vqWA/apArWa/bAxa-havAI/bAxahavAI/ahewu/ahewuka/aviraWA
asaByawaH	asaByawaH/aSiRtawaH/SiRtAcArahInawaH
prayojanawaH	prayojanawaH/kAma_se/kAraNa_se/saprayojana
kaxama-ba_kaxama	pICe-pICe/anupaxa/kaxama-ba_kaxama
PZIsaxI	prawiSawa/PZIsaxI/PIsaxI/paraseMta
se	apekRAkqwa/wulanA_meM/apekRayA/mukZAbale/mukAbale/banisbawa/se
paScawaH	pICe/paScawaH/pACe/pqRTawaH/arvAka
wakZarIbana	aMxAjana/aMxAjZana/anxAjZana/anxAjana/lagaBaga/wakZarIbana/wakarIbana/kZarIba/karIba/karIbakarIba/karIbana/kZarIbakZarIba/kZarIbana/anumAnawaH/anakZarIba/anakarIba/waKZamInana/aMxAja_se/ukavAz
pAzcagunA	pAzcagunA/pacagunA
sAvaXAnIpUrvaka	sAvaXAnIpUrvaka/XyAnapUrvaka/XyAna_se/sAvaXAnI_se/sAvaXAnawaH/samBAlakara/saMBAlakara
anAhaka	vyarWa_hI/yoM_hI/JUTa-mUTa/yOM_hI/yUz_hI/Ese_hI/nAhakZa/nAhaka/PZajZUla/PajUla/PZijZUla/PijUla/anahaka/anAhaka
kEse	kEse/kisa_prakAra_se/kyoMkara/kyUzkara/kEse
barbarawApUrvaka	nirxayawApUrvaka/nirxayawA_se/berahamI_se/bexarxI_se/krUrawApUrvaka/barbarawApUrvaka/kaTorawA_se/kadZAI_se
iwwiPAkana	acAnaka/ekAeka/sahasA/ekabAragI/ikabAragI/yakAyaka/akasmAwa/akasmAw/anAyAsa/xEvAw/xEvavaSa/Ocaka/aprawyASiwawaH/ApAwawaH/aMcakEM/agawyA/acaka/acAMcaka/acAkA/acAka/acAna/anAgawaH/anyAsa/nAgahAz/AcAna/ikahAI/ikahAU/iwwiPZAkZana/iwwiPAkana/iwwaPZAkZana/iwwaPAkana/ucakA/Ocaka/saMyogavaSa/iwwiPZAkZana/iwwiPAkana/iwwaPZAkZana/iwwaPAkana/saMyogavaSAw
ArapAra	Ara-pAra/ArapAra
ukadU	ukadZUz/ukadZU/ukadUz/ukadU/ukurU
jaba_waka	jaba_waka
AdZA	wiraCA/wiryaka/AdZA/teDZA/bAzkA/wirapata
majabUrana	majabUrana/vivaSawaH/anacAhe/majZabUrana/vivaSa_hokara/cAranAcAra/aMwawogawvA/barabasa
ahora-bahora	bAra-bAra/bAra_bAra/bAraMbAra/bArambAra/asakqwa/ahora-bahora
adZosa-padZosa	Asa-pAsa/AsapAsa/agala-bagala/agZala-bagZala/AjU-bAjU/irxa-girxa/adZosa-padZosa/pAsa-padZosa/pAsa_padZosa
nAhakZa	vyarWa_hI/yoM_hI/JUTa-mUTa/yOM_hI/yUz_hI/Ese_hI/nAhakZa/nAhaka/PZajZUla/PajUla/PZijZUla/PijUla/anahaka/anAhaka
barAe_meharabAnI	xayApUrvaka/kqpA_kara_ke/kqpApUrvaka/xayA_se/barAe_meharabAnI
ultA-pultA	ulatA-pulatA/ulatA_pulatA/ulatA-palatA/ultA-paltA/ultA-pultA/ultA_pultA
jiMxagIBara	mqwyuparyanwa/AjIvana/wAumra/umraBara/jZiMxagIBara/jiMxagIBara/jIvanaBara/AmaraNa/aMwima_xama_waka
aBI_BI	aBI_BI
avilaMbawaH	jalxI/SIGra/SIGrawaH/avilaMbawaH/jalxa/acira/wUrNa/SiwAba/begi/avalaMbiwa/avalambiwa/jalxI_se/ASu/avilaMbiwa/avilambiwa
Cina-Cina	prawikRaNa/pala_pala/pala-pala/prawipala/hara_kRaNa/kRaNa-kRaNa/haraGadZI/hara_GadZI/prawi_kRaNa/kRaNakRaNa/anukRaNa/CinaCina/Cina-Cina/AKana
isabAra	aba/abakI/isabAra/aba_kI/isa_bAra
nisaMkoca	nisaMkoca/niHsaMkoca/nissaMkoca/beXadZaka/saMkocahInawaH/beJiJaka/beKataka/beKatake/behicaka
sarAsara	bilkula/bilakula/ekaxama/nipata/sarAsara/TIka/niwAMwa/niwAnwa/pUrNawaH/pUrI_waraha_se/pUrNawayA/saMpUrNawaH/saMpUrNawayA/pUrNarupeNa/AmUlacUla/Sawa-prawiSawa
uwwara	bAxa/bAxa_meM/paScAw/uparAMwa/anaMwara/paScAwa/uparAnwa/ananwara/pICe/uwwara/aWa/anupaxa/anvakRa
jZabaraxaswI	balapUrvaka/barabasa/jZabaraxaswI/jabaraxaswI/jZabarana/jabarana/barajZorI
xUra	xUra/xUrI_para/alaga/pare/xarakinAra/xUra/alaga/eka_waraPZa/eka_ora/alahaxA
PZilahAla	PilahAla/PZilahAla/aba/varwamAna_meM/Aja-kala/Ajakala/Aja_kala/AjakAla/ina_xinoM/isa_samaya/saMprawi/aBI/PZilahAla/PilahAla/isa_samaya/aba/aWa/aXunA/saMprawi/samprawi/aBU/aBE
bepanAha	awyaMwa/awyanwa/awyaXika/be-iMwahA/beiMwahA/bahuwa_aXika/bahuwa_hI/bepanAha/saKZwa/saKwa/jamakara/mahA/nihAyawa/cUdZAMwa/cUdZAnwa/aByaXika/Agara
xveRahInawaH	IrRyAhInawaH/anasUyawaH/xveRahInawaH
takatakI_se	takatakI_se/ekataka/tukura_tukura/taka-taka/animeRa/animiRa/animiKa/anamiKa/ikataka
anyAsa	acAnaka/ekAeka/sahasA/ekabAragI/ikabAragI/yakAyaka/akasmAwa/akasmAw/anAyAsa/xEvAw/xEvavaSa/Ocaka/aprawyASiwawaH/ApAwawaH/aMcakEM/agawyA/acaka/acAMcaka/acAkA/acAka/acAna/anAgawaH/anyAsa/nAgahAz/AcAna/ikahAI/ikahAU/iwwiPZAkZana/iwwiPAkana/iwwaPZAkZana/iwwaPAkana/ucakA/Ocaka
acCI_waraha_se	acCI_waraha/acCI_waraha_se/acCI_waraha/acCI_waraha_se/acCA/baDZiyA/acCI_waraha/acCI_waraha_se/tanAtana/TIka/TIka_se/acCI_waraha/acCI_waraha_se/acCI_waraha/acCI_waraha_se
mOna	cupacApa/cupa/mOna/SAMwa/SAnwa/KZAmoSI_se/KAmoSI_se/niSSabxa/avAka/avAk/bina_bole/mOnawaH
aTagunA	ATagunA/aTagunA
kramAnusAra	kramaSaH/kramAnusAra/yaWAkrama/silasilevAra/bArI-bArI_se/kramavAra/warawIbavAra/ayugapaxa/alpaSaH
harasAla	harasAla/prawivarRa/xarasAla/anuvawsara
sAsUya	IrRyApUrvaka/IrRyawaH/xveRapUrvaka/sAsUya/IrRyApUrNawaH
nissaMxeha	niHsaMxeha/nissaMxeha/jarUra/jZarUra/niHsanxeha/nissanxeha/nisaMxeha/nisanxeha/binA_Saka/beSaka/bilkula/bilakula/yakInana/yakZInana/avaSyameva/avaSya/alabawwA/bilASaka/aBarama/vASinxA/bASinxA/avasi/aviwarkika/asaMSaya/niSciwawaH/ikaMka
Kela_Kela_meM	AsAnI_se/sahajawA_se/saralawA_se/Kela_Kela_meM/sahajawaH/anEse
prayawnawaH	prayawnapUrvaka/sAyAsa/prayawnawaH/prayawna_se
bAijjawa	bAijjawa/bAijZjZawa/sasammAna
KZAsakara	viSeRakara/KZAsakara/KZAsa_wOra_para/KZAsa_wOra_se/KZAsawOra_para/KZAsawOra_se/KAsawOra_para/KAsawOra_se/KAsakara/viSeRawaH/viSiRtawaH/muKyawaH/viSeRa_rUpa_se
jora_se	kasakara/joraxAra/weja/wejZa/wIvra/wejZI_se/jZora_se/wejI_se/jora_se/wIvrawA_se
naMge_pEra	naMge_pEra
vyavasWApUrvaka	warIkZe_se/warIke_se/warawIba_se/kZarIne_se/karIne_se/vyavasWApUrvaka/vyavasWiwawaH/kZarInAvAra/karInAvAra
vyavasWiwawaH	warIkZe_se/warIke_se/warawIba_se/kZarIne_se/karIne_se/vyavasWApUrvaka/vyavasWiwawaH/kZarInAvAra/karInAvAra
soca_vicAra_kara	soca-vicArakara/samaJa-bUJakara/vicArapUrvaka/soca-samaJakara/soca_vicAra_kara/samaJa_bUJa_kara/soca_samaJa_kara/vicAriwawaH
anekaXA	prAyaH/akasara/aksara/aXikawara/aXikAMSawaH/jyAxAwara/bahuXA/AmawOra_para/AmawOra_se/aXikAMSawayA/prAyaSaH/anekaXA
Apa	svayaM/svawaH/Kuxa/KZuxa/Apa/ApahI/apaneApa/KZuxa_hI/sAkRAw/sAkRAwa/asAlawana/AparUpa
akaMtaka	nirbAXa/bAXArahiwa/akaMtaka
abakI	aba/abakI/isabAra/aba_kI/isa_bAra
TaMde-TaMde	TaMde-TaMde/TaMde_TaMde/TaMDe-TaMDe/TaMDe_TaMDe
PajUla	vyarWa_hI/yoM_hI/JUTa-mUTa/yOM_hI/yUz_hI/Ese_hI/nAhakZa/nAhaka/PZajZUla/PajUla/PZijZUla/PijUla/anahaka/anAhaka
WaraWara	Wara-Wara/WaraWara
svaBAvawaH	svaBAvawaH/Axawana
dIMga_mArawe_hue	SeKI_mArawe_hue/dIMga_mArawe_hue
PijUla	vyarWa_hI/yoM_hI/JUTa-mUTa/yOM_hI/yUz_hI/Ese_hI/nAhakZa/nAhaka/PZajZUla/PajUla/PZijZUla/PijUla/anahaka/anAhaka/vyarWa/PZajUla/PijUla/PZijUla/anerA/yoM_hI/vqWA/apArWa/bAxa-havAI/bAxahavAI/ahewu/ahewuka/aviraWA
hAjira	peSa/hAjZira/hAjira
haraxina	prawixina/haraxina/niwya/hararojZa/rojZa/niwa/roja/rojZAnA/rojAnA/anuxina/niwyaprawi/anuxivasa/aharaha
vivaSa_hokara	majabUrana/vivaSawaH/anacAhe/majZabUrana/vivaSa_hokara/cAranAcAra/aMwawogawvA/barabasa
kyoMkara	kyoMkara/kyUzkara/kEse
jZoroM_se	jZora-Sora_se/jora-Sora_se/jZoraSora_se/joraSora_se/jZoroM_se/joroM_se
iwwaPAkana	acAnaka/ekAeka/sahasA/ekabAragI/ikabAragI/yakAyaka/akasmAwa/akasmAw/anAyAsa/xEvAw/xEvavaSa/Ocaka/aprawyASiwawaH/ApAwawaH/aMcakEM/agawyA/acaka/acAMcaka/acAkA/acAka/acAna/anAgawaH/anyAsa/nAgahAz/AcAna/ikahAI/ikahAU/iwwiPZAkZana/iwwiPAkana/iwwaPZAkZana/iwwaPAkana/ucakA/Ocaka/saMyogavaSa/iwwiPZAkZana/iwwiPAkana/iwwaPZAkZana/iwwaPAkana/saMyogavaSAw
spaRtawayA	spaRta/spaRtawaH/Kula_kara/Kule_wOra_para/Kullama_KullA/binA_lAga_lapeta_ke/sAPZa_sAPZa/spaRtawayA/sAPZa-sAPZa/sAPa-sAPa
Binasahare	BinasAre/Binasahare
XUAzXAra	lagAwAra/anavarawa/niraMwara/niranwara/wAbadZawodZa/xanAxana/sawawa/XUAzXAra/anaMwara/ananwara/avirAmawaH/aniSa/prawikRaNa/anukRaNa/XadZAXadZa/avirawa/muwwasila/avicCinna/avicCexa/aviSrAnwa/aviSrAMwa/asarAra/aharaha/AsaMga/Asafga/ikawAra
anusAra	anusAra/mAPika/muwAbika/anukUla/muAPZikZa/muAPika/muwAbikZa/aprawIRa
barabasa	majabUrana/vivaSawaH/anacAhe/majZabUrana/vivaSa_hokara/cAranAcAra/aMwawogawvA/barabasa/balapUrvaka/barabasa/jZabaraxaswI/jabaraxaswI/jZabarana/jabarana/barajZorI
xayA_se	xayApUrvaka/kqpA_kara_ke/kqpApUrvaka/xayA_se/barAe_meharabAnI
alam	basa/alam/alaM/paryApwa/kAPI/kAPZI/yaWeRta/alam/alaM
sAmUhika_rUpa_se	samUhawaH/sAmUhika_rUpa_se
anavaXi	hameSA/saxA/niwya/saxEva/niwya_prawi/sarvaxA/sarvaWA/haraxama/haravakwa/harasamaya/xina-rAwa/xinarAwa/xina_rAwa/rAwa-xina/rAwaxina/niSixina/nisa-vAsara/nisavAsara/niSivAsara/niranwara/niraMwara/anavaXi/sarvaxEva/aharaha/pinnA/aharniSa/ahorAwra
baje	baje
alaM	basa/alam/alaM/paryApwa/kAPI/kAPZI/yaWeRta/alam/alaM
majZabUwI_se	xqDZawApUrvaka/majabUwI_se/majZabUwI_se
asakqwa	bAra-bAra/bAra_bAra/bAraMbAra/bArambAra/asakqwa/ahora-bahora
AmawOra_se	prAyaH/akasara/aksara/aXikawara/aXikAMSawaH/jyAxAwara/bahuXA/AmawOra_para/AmawOra_se/aXikAMSawayA/prAyaSaH/anekaXA
ekajuta	ekajuta
muwwasila	pAsa_meM/najZaxIka/najaxIka/nikata_meM/kZarIba_meM/samIpa/nikata/pAsa/kZarIba/karIba/sannikata/najIka/muwwasila/arvAka/avixUra/Are/AsapAsa/Asa-pAsa/lagAwAra/anavarawa/niraMwara/niranwara/wAbadZawodZa/xanAxana/sawawa/XUAzXAra/anaMwara/ananwara/avirAmawaH/aniSa/prawikRaNa/anukRaNa/XadZAXadZa/avirawa/muwwasila/avicCinna/avicCexa/aviSrAnwa/aviSrAMwa/asarAra/aharaha/AsaMga/Asafga/ikawAra
ulatA_pulatA	ulatA-pulatA/ulatA_pulatA/ulatA-palatA/ultA-paltA/ultA-pultA/ultA_pultA
iXara-uXara	iXara-uXara/jahAz-wahAz/yahAz-vahAz/iwauwa/iwaswawaH
bIcoM_bIca	bIcobIca/bIcoMbIca/bIcoM-bIca/bIcama_bIca/bIcoM_bIca
ina_xinoM	PilahAla/PZilahAla/aba/varwamAna_meM/Aja-kala/Ajakala/Aja_kala/AjakAla/ina_xinoM/isa_samaya/saMprawi
xqDZawApUrvaka	saMkalpapUrvaka/irAxawana/irAxe_se/xqDZawApUrvaka/niScayapUrvaka/xqDZawApUrvaka/majabUwI_se/majZabUwI_se
sakuSala	sakuSala/kuSalawApUrvaka/kuSalapUrvaka/sahI_salAmawa/sahI-salAmawa/TIka-TAka/TIka_se/TIka-TAka_se/TIkaTAka/baKZEra/baKEra/baKZErIya/baKErIyawa/surakRiwawaH
eka_eka_daga	kZaxama_ba_kZaxama/eka_eka_daga/paxa_prawi_paxa
isa_waraha	yoM/yUz/Ese/isa_waraha/isa_prakAra/EsA/iwWaM/ima/imi/iBa/iva/isE/IxqS/IxqSa
kZaxama_ba_kZaxama	kZaxama_ba_kZaxama/eka_eka_daga/paxa_prawi_paxa
abawaka	aba_waka/aBI_waka/Aja_waka/abawaka/aBIwaka/Ajawaka/ajahuz/ajahUz/ajo/ajOM/abalaga
Kule_wOra_para	spaRta/spaRtawaH/Kula_kara/Kule_wOra_para/Kullama_KullA/binA_lAga_lapeta_ke/sAPZa_sAPZa/spaRtawayA/sAPZa-sAPZa/sAPa-sAPa
mukAbale	apekRAkqwa/wulanA_meM/apekRayA/mukZAbale/mukAbale/banisbawa/se
iwe	iwanA/iwA/iweka/iwe
nisaMxeha	niHsaMxeha/nissaMxeha/jarUra/jZarUra/niHsanxeha/nissanxeha/nisaMxeha/nisanxeha/binA_Saka/beSaka/bilkula/bilakula/yakInana/yakZInana/avaSyameva/avaSya/alabawwA/bilASaka/aBarama/vASinxA/bASinxA/avasi/aviwarkika/asaMSaya/niSciwawaH/ikaMka
iwa	iXara/isa_ora/yahAz_para/iwaH/iwa/iwE/iwWe/yahAz/isa_jagaha/iwaH/iwa/iha/ihAz/ihavAz/IMGe/IhAz
Anana-PAnana_meM	Jatapata/catapata/PatAPata/wuraMwa/wuranwa/wawkAla/avilaMba/avilamba/PZOrana/POrana/KatAka_se/wawkRaNa/wadZAka_se/wadZa_se/wapAka_se/awiSIGra/awiSIGrawaH/jalxa_se_jalxa/jalxI_se_jalxI/wadZa_se/hAWoM-hAWa/hAWoM_hAWa/hAWo-hAWa/hAWo_hAWa/Kata_se/Anana-PAnana_meM/AnanaPAnana_meM/siwAba/siwAbI/besAKwA/TahAkA/ikahAI/ikahAU
ApahI	svayaM/svawaH/Kuxa/KZuxa/Apa/ApahI/apaneApa/KZuxa_hI/sAkRAw/sAkRAwa/asAlawana/AparUpa
waKZamInana	aMxAjana/aMxAjZana/anxAjZana/anxAjana/lagaBaga/wakZarIbana/wakarIbana/kZarIba/karIba/karIbakarIba/karIbana/kZarIbakZarIba/kZarIbana/anumAnawaH/anakZarIba/anakarIba/waKZamInana/aMxAja_se/ukavAz
AKZira	aMwawaH/aMwawogawvA/aMwa_meM/AKira/AKZira/AKZirakAra/AKirakAra/howe_havAwe
iweka	iwanA/iwA/iweka/iwe
iwE	iXara/isa_ora/yahAz_para/iwaH/iwa/iwE/iwWe
iwA	iwanA/iwA/iweka/iwe
saMBavawaH	saMBavawaH/SAyaxa/syaw
kqpayA	kqpayA/kqpApUrvaka/kqpA_pUrvaka/kqpA_karake/meharabAnI_karake
uXara	uXara/usa_ora/pare/uwa/uwana
sahasA	acAnaka/ekAeka/sahasA/ekabAragI/ikabAragI/yakAyaka/akasmAwa/akasmAw/anAyAsa/xEvAw/xEvavaSa/Ocaka/aprawyASiwawaH/ApAwawaH/aMcakEM/agawyA/acaka/acAMcaka/acAkA/acAka/acAna/anAgawaH/anyAsa/nAgahAz/AcAna/ikahAI/ikahAU/iwwiPZAkZana/iwwiPAkana/iwwaPZAkZana/iwwaPAkana/ucakA/Ocaka
anxAjana	aMxAjana/aMxAjZana/anxAjZana/anxAjana/lagaBaga/wakZarIbana/wakarIbana/kZarIba/karIba/karIbakarIba/karIbana/kZarIbakZarIba/kZarIbana/anumAnawaH/anakZarIba/anakarIba/waKZamInana/aMxAja_se/ukavAz
isIlie	isalie/isIlie/awaeva/awaH/lihAjA/lihAjZA
bamuSkila	kaTinAI_se/jEse_wEse/muSkila_se/bamuSkila/kaTinawaH/nITi
nisvArWa	nisvArWa/niHsvArWa
isa_samaya	PilahAla/PZilahAla/aba/varwamAna_meM/Aja-kala/Ajakala/Aja_kala/AjakAla/ina_xinoM/isa_samaya/saMprawi/aBI/PZilahAla/PilahAla/isa_samaya/aba/aWa/aXunA/saMprawi/samprawi/aBU/aBE
aByaXika	awyaMwa/awyanwa/awyaXika/be-iMwahA/beiMwahA/bahuwa_aXika/bahuwa_hI/bepanAha/saKZwa/saKwa/jamakara/mahA/nihAyawa/cUdZAMwa/cUdZAnwa/aByaXika/Agara
kyoM	kyoM/kisalie/kisa_vAswe
xera-savera	xera-savera/kaBI_na_kaBI/xera-savera/avera-savera
sabase_pahale	Age-Age/Age_kI_ora/sabase_pahale
irxa-girxa	cAroM_ora/cAroM_waraPZa/cAroM_waraPa/cahuz_ora/sarvawra/saBI_waraPZa/cAroM_xiSAoM_meM/hara_jagaha/irxa-girxa/Asa-pAsa/AsapAsa/agala-bagala/agZala-bagZala/AjU-bAjU/irxa-girxa/adZosa-padZosa/pAsa-padZosa/pAsa_padZosa
avyavasWiwa	wiwara-biwara/aswa-vyaswa/Cinna-Binna/bewarawIba/aswavyaswa/_avyavasWiwa
yaWAsaMBava	yaWASakwi/Barasaka/yaWAsAXya/yaWAsaMBava/kRamawAnusAra/yaWAkRama
AjIvana	mqwyuparyanwa/AjIvana/wAumra/umraBara/jZiMxagIBara/jiMxagIBara/jIvanaBara/AmaraNa/aMwima_xama_waka
prasannawApUrvaka	prasannawApUrvaka/KZuSI_KZuSI/KuSI_KuSI/KZuSI_se/KuSI_se/prasannawaH/saharRa/harRapUrvaka
baKZErIya	sakuSala/kuSalawApUrvaka/kuSalapUrvaka/sahI_salAmawa/sahI-salAmawa/TIka-TAka/TIka_se/TIka-TAka_se/TIkaTAka/baKZEra/baKEra/baKZErIya/baKErIyawa/surakRiwawaH
KuleAma	KuleAma/Kulakara/sareAma/sare-Ama/Kule-Ama/Kullama-KullA/KullamaKullA/daMke_kI_cota_para/sare_Ama/agupwawaH
jAzca_paraKa_kara	jAzca_paraKakara/jAzca_paraKa_kara
aMxAjZana	aMxAjana/aMxAjZana/anxAjZana/anxAjana/lagaBaga/wakZarIbana/wakarIbana/kZarIba/karIba/karIbakarIba/karIbana/kZarIbakZarIba/kZarIbana/anumAnawaH/anakZarIba/anakarIba/waKZamInana/aMxAja_se/ukavAz
xarapeSa	sAmane/Age/samakRa/sammuKa/agre/anvakRa/aBimuKa/xarapeSa/Agala/AgalA
UrxXva	Upara/UzcAI_para/UrxXva/UrXva
baKZEra	sakuSala/kuSalawApUrvaka/kuSalapUrvaka/sahI_salAmawa/sahI-salAmawa/TIka-TAka/TIka_se/TIka-TAka_se/TIkaTAka/baKZEra/baKEra/baKZErIya/baKErIyawa/surakRiwawaH
yaxi	yaxi/agara/jaba
wejI_se	kasakara/joraxAra/weja/wejZa/wIvra/wejZI_se/jZora_se/wejI_se/jora_se/wIvrawA_se
yaxA	jaba/yaxA
sagarva	aBimAnapUrvaka/aBimAna_se/sagarva/sABimAna
BalIBAzwi	BalI-BAzwi/BalI_BAzwi/BarapUra/BalIBAzwi/BalI-BAMwi/BalI_BAMwi/BalIBAMwi/sarvawoBAva/acCI_waraha
iwwiPZAkZana	acAnaka/ekAeka/sahasA/ekabAragI/ikabAragI/yakAyaka/akasmAwa/akasmAw/anAyAsa/xEvAw/xEvavaSa/Ocaka/aprawyASiwawaH/ApAwawaH/aMcakEM/agawyA/acaka/acAMcaka/acAkA/acAka/acAna/anAgawaH/anyAsa/nAgahAz/AcAna/ikahAI/ikahAU/iwwiPZAkZana/iwwiPAkana/iwwaPZAkZana/iwwaPAkana/ucakA/Ocaka/saMyogavaSa/iwwiPZAkZana/iwwiPAkana/iwwaPZAkZana/iwwaPAkana/saMyogavaSAw
ahorAwra	hameSA/saxA/niwya/saxEva/niwya_prawi/sarvaxA/sarvaWA/haraxama/haravakwa/harasamaya/xina-rAwa/xinarAwa/xina_rAwa/rAwa-xina/rAwaxina/niSixina/nisa-vAsara/nisavAsara/niSivAsara/niranwara/niraMwara/anavaXi/sarvaxEva/aharaha/pinnA/aharniSa/ahorAwra
niwAMwa	bilkula/bilakula/ekaxama/nipata/sarAsara/TIka/niwAMwa/niwAnwa/pUrNawaH/pUrI_waraha_se/pUrNawayA/saMpUrNawaH/saMpUrNawayA/pUrNarupeNa/AmUlacUla/Sawa-prawiSawa
kiMkarwavya-vimUDZa	hakkA-bakkA/BOMcakkA/kiMkarwavya-vimUDZa/kiMkarwwavya-vimUDZa/kiMkarwavyavimUDZa/kiMkarwwavyavimUDZa/hawabuxXi
vivaSawaH	majabUrana/vivaSawaH/anacAhe/majZabUrana/vivaSa_hokara/cAranAcAra/aMwawogawvA/barabasa
SuruvAwa_meM	AraMBa_meM/AraMBawaH/AramBawaH/pahale/SurU_meM/praWama/Axi_meM/praWamawaH/sarvapraWama/pUrva/SuruAwa_meM/SuruvAwa_meM/AramBa_meM/prAramBa_meM
nikata	pAsa_meM/najZaxIka/najaxIka/nikata_meM/kZarIba_meM/samIpa/nikata/pAsa/kZarIba/karIba/sannikata/najIka/muwwasila/arvAka/avixUra/Are/AsapAsa/Asa-pAsa
anuvawsara	harasAla/prawivarRa/xarasAla/anuvawsara
yaWAsAXya	yaWASakwi/Barasaka/yaWAsAXya/yaWAsaMBava/kRamawAnusAra/yaWAkRama
ekAkI	akelA/akele/kevala/sirPZa/mAwra/KAlI/KZAlI/basa/nipata/mahajZa/sirPa/wanhA/wanahA/ekAkI/ekameva/ekaMga/ikelA
IhAz	yahAz/isa_jagaha/iwaH/iwa/iha/ihAz/ihavAz/IMGe/IhAz
vAswava_meM	vAkaI/vAkZaI/vAswava_meM/hakIkawana/hakZIkZawana/xaraasala/asala_meM/sacamuca/saccI-muccI/saccI_muccI/sawyawaH/vaswuwaH
sIXe	sIXe/sIXA/sIXe/sIXA/sAmane/sIXe/sIXe/sIXA/sIXe/sIXA/sIXe/sIXA
bAra-bAra	bAra-bAra/bAra_bAra/bAraMbAra/bArambAra/asakqwa/ahora-bahora
AiMxA	aba/Age/AinxA/AiMxA/AyaMxA/AyanxA
acCA_ho_ki	aXimAnawaH/varIyawA_se/acCA_ho_ki
sIXA	sIXe/sIXA/sIXe/sIXA/sAmane/sIXe/sIXA/sIXe/sIXA/sIXe/sIXA
kamobeSa	kamobeSa/kamabeSa/nyUnAXika
ikatTA	sAWa-sAWa/sAWa_hI/sAWa_hI_sAWa/sAWa/eka_sAWa/ikatTA/ikajora/ekawra/ikawra
sAScarya	AScaryapUrvaka/savismaya/sAScarya
hakIkawana	vAkaI/vAkZaI/vAswava_meM/hakIkawana/hakZIkZawana/xaraasala/asala_meM/sacamuca/saccI-muccI/saccI_muccI/sawyawaH/vaswuwaH
soca-vicArakara	soca-vicArakara/samaJa-bUJakara/vicArapUrvaka/soca-samaJakara/soca_vicAra_kara/samaJa_bUJa_kara/soca_samaJa_kara/vicAriwawaH
maxxenajZara	maxxenajZara/maxxenajara
ukadZU	ukadZUz/ukadZU/ukadUz/ukadU/ukurU
kZiswoM_meM	kZiswavAra/kiswavAra/kZiswa_xara_kZiswa/kZiswoM_meM
SabxaSaH	akRaraSaH/SabxaSaH/aXyakRara
isI_waraha	isI_waraha/isI_prakAra/iwWaMmeva
iva	yoM/yUz/Ese/isa_waraha/isa_prakAra/EsA/iwWaM/ima/imi/iBa/iva/isE/IxqS/IxqSa/vEse/vEsA/usI_waraha/usa_waraha/iva
kadZA	bahuwa/KZUba/KUba/badZA/jyAxA/jZyAxA/aXika/kAPZI/kAPI/kadZA/jamakara/datakara
saba_meM	saba_meM
Pira_BI	Pira_BI/waWApi/waba_BI
wadZAwadZa	wadZAwadZa
AXAra_para	Upara/AXAra_para
AyanxA	aba/Age/AinxA/AiMxA/AyaMxA/AyanxA
aharniSa	hameSA/saxA/niwya/saxEva/niwya_prawi/sarvaxA/sarvaWA/haraxama/haravakwa/harasamaya/xina-rAwa/xinarAwa/xina_rAwa/rAwa-xina/rAwaxina/niSixina/nisa-vAsara/nisavAsara/niSivAsara/niranwara/niraMwara/anavaXi/sarvaxEva/aharaha/pinnA/aharniSa/ahorAwra
sasammAna	sawkArapUrvaka/sAxara/sasammAna/Axara_sahiwa/bAijjawa/bAijZjZawa/sasammAna
alahaxA	xarakinAra/xUra/alaga/eka_waraPZa/eka_ora/alahaxA
ruka-rukakara	ruka-ruka_kara/ruka-rukakara/virAmawaH/Tahara_Tahara_kara/savirAmawaH
girawe_padZawe	girawe_padZawe/girawe-padZawe
bilkula	niHsaMxeha/nissaMxeha/jarUra/jZarUra/niHsanxeha/nissanxeha/nisaMxeha/nisanxeha/binA_Saka/beSaka/bilkula/bilakula/yakInana/yakZInana/avaSyameva/avaSya/alabawwA/bilASaka/aBarama/vASinxA/bASinxA/avasi/aviwarkika/asaMSaya/niSciwawaH/ikaMka/bilkula/bilakula/ekaxama/nipata/sarAsara/TIka/niwAMwa/niwAnwa/pUrNawaH/pUrI_waraha_se/pUrNawayA/saMpUrNawaH/saMpUrNawayA/pUrNarupeNa/AmUlacUla/Sawa-prawiSawa
I_pa	IsA_paScAw/I_pa/edI/IsA_paScAw
taka-taka	takatakI_se/ekataka/tukura_tukura/taka-taka/animeRa/animiRa/animiKa/anamiKa/ikataka
uxAharaNawaH	uxAharaNArWa/uxAharaNawaH/uxAharaNa_svarUpa/masalana
saMkocahInawaH	nisaMkoca/niHsaMkoca/nissaMkoca/beXadZaka/saMkocahInawaH/beJiJaka/beKataka/beKatake/behicaka
kaWanAnusAra	kaWanAnusAra/kahanAnusAra/kahe_muwAbika/kahe_muwAbikZa/kahe_anusAra
sammuKa	sAmane/Age/samakRa/sammuKa/agre/anvakRa/aBimuKa/xarapeSa/Agala/AgalA
jZarA	jarA/jZarA/jarA-sA/jZarA-sA/rawwiBara/WodZA/WodZA-sA/WodZA_sA/wanika/yawkiMciw
PZijZUla	vyarWa_hI/yoM_hI/JUTa-mUTa/yOM_hI/yUz_hI/Ese_hI/nAhakZa/nAhaka/PZajZUla/PajUla/PZijZUla/PijUla/anahaka/anAhaka
cawurguNa	cOgunA/cAra_gunA/cAragunA/cawurguNa
leSamAwra	nAmamAwra/leSamAwra/raMcamAwra/WodZA_sA
sannikata	pAsa_meM/najZaxIka/najaxIka/nikata_meM/kZarIba_meM/samIpa/nikata/pAsa/kZarIba/karIba/sannikata/najIka/muwwasila/arvAka/avixUra/Are/AsapAsa/Asa-pAsa
warIke_se	warIkZe_se/warIke_se/warawIba_se/kZarIne_se/karIne_se/vyavasWApUrvaka/vyavasWiwawaH/kZarInAvAra/karInAvAra
eka_waraPa	eka_ora/eka_waraPa/eka_waraPZa
warasoM	narasoM/awarasoM/warasoM/narasoM/awarasoM/warasoM
ulatA-pulatA	ulatA-pulatA/ulatA_pulatA/ulatA-palatA/ultA-paltA/ultA-pultA/ultA_pultA
xvAra-xvAra	xara-xara/xara-baxara/xvAra-xvAra
saMpUrNawayA	bilkula/bilakula/ekaxama/nipata/sarAsara/TIka/niwAMwa/niwAnwa/pUrNawaH/pUrI_waraha_se/pUrNawayA/saMpUrNawaH/saMpUrNawayA/pUrNarupeNa/AmUlacUla/Sawa-prawiSawa
Gara_Gara	Gara-Gara/Gara_Gara
IxqS	yoM/yUz/Ese/isa_waraha/isa_prakAra/EsA/iwWaM/ima/imi/iBa/iva/isE/IxqS/IxqSa
kawaI	kaxApi/haragijZa/kawaI/kawwaI
viXipUrvaka	viXipUrvaka/kZAyaxe_se/DaMga_se/warIkZe_se/bawOra/bAkZAyaxA/viXivaw/viXivawa
muwAbika	anusAra/mAPika/muwAbika/anukUla/muAPZikZa/muAPika/muwAbikZa/aprawIRa
mAWe	Barose/mAWe
sAvaXAnawaH	sAvaXAnIpUrvaka/XyAnapUrvaka/XyAna_se/sAvaXAnI_se/sAvaXAnawaH/samBAlakara/saMBAlakara
kZarIba_meM	pAsa_meM/najZaxIka/najaxIka/nikata_meM/kZarIba_meM/samIpa/nikata/pAsa/kZarIba/karIba/sannikata/najIka/muwwasila/arvAka/avixUra/Are/AsapAsa/Asa-pAsa
uxxeSyawaH	uxxeSyapUrvaka/uxxeSyawaH/sABiprAyaH/soxxeSya
sABimAna	aBimAnapUrvaka/aBimAna_se/sagarva/sABimAna
aBimuKa	sAmane/Age/samakRa/sammuKa/agre/anvakRa/aBimuKa/xarapeSa/Agala/AgalA
anakZarIba	aMxAjana/aMxAjZana/anxAjZana/anxAjana/lagaBaga/wakZarIbana/wakarIbana/kZarIba/karIba/karIbakarIba/karIbana/kZarIbakZarIba/kZarIbana/anumAnawaH/anakZarIba/anakarIba/waKZamInana/aMxAja_se/ukavAz
aBI_waka	aba_waka/aBI_waka/Aja_waka/abawaka/aBIwaka/Ajawaka/ajahuz/ajahUz/ajo/ajOM/abalaga
bemOke	kusamaya/gZalawa_vakZwa_para/asamaya/bevakZwa/galawa_vakwa_para/bevakwa/bemOke/asamaya/bevakZwa/bevakwa/gZalawa_samaya_para/galawa_samaya_para/bemOke
nAhaka	vyarWa_hI/yoM_hI/JUTa-mUTa/yOM_hI/yUz_hI/Ese_hI/nAhakZa/nAhaka/PZajZUla/PajUla/PZijZUla/PijUla/anahaka/anAhaka
bIcoMbIca	bIcobIca/bIcoMbIca/bIcoM-bIca/bIcama_bIca/bIcoM_bIca
kiXara	kiXara
samAnAMwara	samAMwara/samAnAMwara/samAnwara/samAnAnwara
kZiswavAra	kZiswavAra/kiswavAra/kZiswa_xara_kZiswa/kZiswoM_meM
yahAz-vahAz	iXara-uXara/jahAz-wahAz/yahAz-vahAz/iwauwa/iwaswawaH
niwya	prawixina/haraxina/niwya/hararojZa/rojZa/niwa/roja/rojZAnA/rojAnA/anuxina/niwyaprawi/anuxivasa/aharaha/hameSA/saxA/niwya/saxEva/niwya_prawi/sarvaxA/sarvaWA/haraxama/haravakwa/harasamaya/xina-rAwa/xinarAwa/xina_rAwa/rAwa-xina/rAwaxina/niSixina/nisa-vAsara/nisavAsara/niSivAsara/niranwara/niraMwara/anavaXi/sarvaxEva/aharaha/pinnA/aharniSa/ahorAwra
yUz_hI	akAraNa/prayojanahInawaH/Ese_hI/yUz_hI/kAraNahInawaH/bevajaha/uxxeSyahInawaH/vyarWa_hI/yoM_hI/JUTa-mUTa/yOM_hI/yUz_hI/Ese_hI/nAhakZa/nAhaka/PZajZUla/PajUla/PZijZUla/PijUla/anahaka/anAhaka
behicaka	nisaMkoca/niHsaMkoca/nissaMkoca/beXadZaka/saMkocahInawaH/beJiJaka/beKataka/beKatake/behicaka
beXadZaka	nisaMkoca/niHsaMkoca/nissaMkoca/beXadZaka/saMkocahInawaH/beJiJaka/beKataka/beKatake/behicaka
mahajZa	akelA/akele/kevala/sirPZa/mAwra/KAlI/KZAlI/basa/nipata/mahajZa/sirPa/wanhA/wanahA/ekAkI/ekameva/ekaMga/ikelA
xarakinAra	xarakinAra/xUra/alaga/eka_waraPZa/eka_ora/alahaxA
hAWo_hAWa	Jatapata/catapata/PatAPata/wuraMwa/wuranwa/wawkAla/avilaMba/avilamba/PZOrana/POrana/KatAka_se/wawkRaNa/wadZAka_se/wadZa_se/wapAka_se/awiSIGra/awiSIGrawaH/jalxa_se_jalxa/jalxI_se_jalxI/wadZa_se/hAWoM-hAWa/hAWoM_hAWa/hAWo-hAWa/hAWo_hAWa/Kata_se/Anana-PAnana_meM/AnanaPAnana_meM/siwAba/siwAbI/besAKwA/TahAkA/ikahAI/ikahAU
kramavAra	kramaSaH/kramAnusAra/yaWAkrama/silasilevAra/bArI-bArI_se/kramavAra/warawIbavAra/ayugapaxa/alpaSaH
Kulakara	KuleAma/Kulakara/sareAma/sare-Ama/Kule-Ama/Kullama-KullA/KullamaKullA/daMke_kI_cota_para/sare_Ama/agupwawaH
kqwajFawApUrvaka	sABAra/kqwajFawApUrvaka
najZaxIka	pAsa_meM/najZaxIka/najaxIka/nikata_meM/kZarIba_meM/samIpa/nikata/pAsa/kZarIba/karIba/sannikata/najIka/muwwasila/arvAka/avixUra/Are/AsapAsa/Asa-pAsa
sarvawra	cAroM_ora/cAroM_waraPZa/cAroM_waraPa/cahuz_ora/sarvawra/saBI_waraPZa/cAroM_xiSAoM_meM/hara_jagaha/irxa-girxa
xEvAw	acAnaka/ekAeka/sahasA/ekabAragI/ikabAragI/yakAyaka/akasmAwa/akasmAw/anAyAsa/xEvAw/xEvavaSa/Ocaka/aprawyASiwawaH/ApAwawaH/aMcakEM/agawyA/acaka/acAMcaka/acAkA/acAka/acAna/anAgawaH/anyAsa/nAgahAz/AcAna/ikahAI/ikahAU/iwwiPZAkZana/iwwiPAkana/iwwaPZAkZana/iwwaPAkana/ucakA/Ocaka
bASinxA	niHsaMxeha/nissaMxeha/jarUra/jZarUra/niHsanxeha/nissanxeha/nisaMxeha/nisanxeha/binA_Saka/beSaka/bilkula/bilakula/yakInana/yakZInana/avaSyameva/avaSya/alabawwA/bilASaka/aBarama/vASinxA/bASinxA/avasi/aviwarkika/asaMSaya/niSciwawaH/ikaMka
jEse_kA_wEse	jyoM_kA_wyoM/jEse_kA_wEse
aMwawogawvA	aMwawaH/aMwawogawvA/aMwa_meM/AKira/AKZira/AKZirakAra/AKirakAra/howe_havAwe/majabUrana/vivaSawaH/anacAhe/majZabUrana/vivaSa_hokara/cAranAcAra/aMwawogawvA/barabasa
sareAma	KuleAma/Kulakara/sareAma/sare-Ama/Kule-Ama/Kullama-KullA/KullamaKullA/daMke_kI_cota_para/sare_Ama/agupwawaH
baKUbI	baKZUbI/baKUbI
kaxApi	kaxApi/haragijZa/kawaI/kawwaI
awaeva	isalie/isIlie/awaeva/awaH/lihAjA/lihAjZA
sAXAraNawayA	sAmAnyawaH/sAmAnyawayA/sAXAraNawaH/sAXAraNawayA/amUmana/umUmana
jahAz_wahAz	kramahInawaH/akramawaH/avyavasWiwawaH/jahAz_wahAz
yUz	yoM/yUz/Ese/isa_waraha/isa_prakAra/EsA/iwWaM/ima/imi/iBa/iva/isE/IxqS/IxqSa
nisavAsara	hameSA/saxA/niwya/saxEva/niwya_prawi/sarvaxA/sarvaWA/haraxama/haravakwa/harasamaya/xina-rAwa/xinarAwa/xina_rAwa/rAwa-xina/rAwaxina/niSixina/nisa-vAsara/nisavAsara/niSivAsara/niranwara/niraMwara/anavaXi/sarvaxEva/aharaha/pinnA/aharniSa/ahorAwra
samBAlakara	sAvaXAnIpUrvaka/XyAnapUrvaka/XyAna_se/sAvaXAnI_se/sAvaXAnawaH/samBAlakara/saMBAlakara
saprayojana	prayojanawaH/kAma_se/kAraNa_se/saprayojana
cObArA	cObArA
wIvrawA_se	kasakara/joraxAra/weja/wejZa/wIvra/wejZI_se/jZora_se/wejI_se/jora_se/wIvrawA_se
piCale_xinoM_meM	awIwa_meM/pahale/BUwa_meM/BUwa_kAla_meM/pICe/piCale_xinoM_meM
lAparavAhI_se	asAvaXAnawaH/asAvaXAnI_se/XyAnahInawaH/lAparavAhI_se
prawirUpawaH	prawirUpawaH/hUbahU/hU-ba-hU
KuSI_se	prasannawApUrvaka/KZuSI_KZuSI/KuSI_KuSI/KZuSI_se/KuSI_se/prasannawaH/saharRa/harRapUrvaka
daMke_kI_cota_para	KuleAma/Kulakara/sareAma/sare-Ama/Kule-Ama/Kullama-KullA/KullamaKullA/daMke_kI_cota_para/sare_Ama/agupwawaH
nimiRa-mAwra	palaBara/pala-Bara/nimiRa-mAwra/nimeRa-mAwra
samaJa_bUJa_kara	soca-vicArakara/samaJa-bUJakara/vicArapUrvaka/soca-samaJakara/soca_vicAra_kara/samaJa_bUJa_kara/soca_samaJa_kara/vicAriwawaH
icCAnukula	icCAnusAra/icCAnukula/yaWecCa/yaWABIRta/yaWAvAMCiwa
Kullama_KullA	spaRta/spaRtawaH/Kula_kara/Kule_wOra_para/Kullama_KullA/binA_lAga_lapeta_ke/sAPZa_sAPZa/spaRtawayA/sAPZa-sAPZa/sAPa-sAPa
beArAma	beArAma
pala-Bara	palaBara/pala-Bara/nimiRa-mAwra/nimeRa-mAwra
kAnUnana	kZAnUnana/kAnUnana/viXAnawaH
anaMwara	bAxa/bAxa_meM/paScAw/uparAMwa/anaMwara/paScAwa/uparAnwa/ananwara/pICe/uwwara/aWa/anupaxa/anvakRa/lagAwAra/anavarawa/niraMwara/niranwara/wAbadZawodZa/xanAxana/sawawa/XUAzXAra/anaMwara/ananwara/avirAmawaH/aniSa/prawikRaNa/anukRaNa/XadZAXadZa/avirawa/muwwasila/avicCinna/avicCexa/aviSrAnwa/aviSrAMwa/asarAra/aharaha/AsaMga/Asafga/ikawAra
pAsa	pAsa_meM/najZaxIka/najaxIka/nikata_meM/kZarIba_meM/samIpa/nikata/pAsa/kZarIba/karIba/sannikata/najIka/muwwasila/arvAka/avixUra/Are/AsapAsa/Asa-pAsa/pAsa
kZarIba	pAsa_meM/najZaxIka/najaxIka/nikata_meM/kZarIba_meM/samIpa/nikata/pAsa/kZarIba/karIba/sannikata/najIka/muwwasila/arvAka/avixUra/Are/AsapAsa/Asa-pAsa/aMxAjana/aMxAjZana/anxAjZana/anxAjana/lagaBaga/wakZarIbana/wakarIbana/kZarIba/karIba/karIbakarIba/karIbana/kZarIbakZarIba/kZarIbana/anumAnawaH/anakZarIba/anakarIba/waKZamInana/aMxAja_se/ukavAz
uxxeSyahInawaH	uxxeSyahInawaH/niruxxeSya/niruxxeSyawaH/akAraNa/prayojanahInawaH/Ese_hI/yUz_hI/kAraNahInawaH/bevajaha/uxxeSyahInawaH
gZalawa_vakZwa_para	kusamaya/gZalawa_vakZwa_para/asamaya/bevakZwa/galawa_vakwa_para/bevakwa/bemOke
bAra_bAra	bAra-bAra/bAra_bAra/bAraMbAra/bArambAra/asakqwa/ahora-bahora
yoM	yoM/yUz/Ese/isa_waraha/isa_prakAra/EsA/iwWaM/ima/imi/iBa/iva/isE/IxqS/IxqSa
sUkRmawaH	bArIkZI_se/bArIkI_se/sUkRmawaH
Ese	yoM/yUz/Ese/isa_waraha/isa_prakAra/EsA/iwWaM/ima/imi/iBa/iva/isE/IxqS/IxqSa
vEsA	vEse/vEsA/usI_waraha/usa_waraha/iva
kaba	kaba_waka/kaba
Aja_waka	aba_waka/aBI_waka/Aja_waka/abawaka/aBIwaka/Ajawaka/ajahuz/ajahUz/ajo/ajOM/abalaga
vEse	vEse/vEsA/usI_waraha/usa_waraha/iva
EsA	yoM/yUz/Ese/isa_waraha/isa_prakAra/EsA/iwWaM/ima/imi/iBa/iva/isE/IxqS/IxqSa
patta	pata/patta/petakEyAz
vicArahInawaH	vicArahInawaH/anasoce/besoce_samaJe
TIka-TAka_se	sakuSala/kuSalawApUrvaka/kuSalapUrvaka/sahI_salAmawa/sahI-salAmawa/TIka-TAka/TIka_se/TIka-TAka_se/TIkaTAka/baKZEra/baKEra/baKZErIya/baKErIyawa/surakRiwawaH
aba_kI	aba/abakI/isabAra/aba_kI/isa_bAra
warakIba_se	yukwipUrvaka/upAyawaH/upAya_se/jugawa_lagAkara/warakIba_se/warIkZe_se
ihAz	yahAz/isa_jagaha/iwaH/iwa/iha/ihAz/ihavAz/IMGe/IhAz
KAsakara	viSeRakara/KZAsakara/KZAsa_wOra_para/KZAsa_wOra_se/KZAsawOra_para/KZAsawOra_se/KAsawOra_para/KAsawOra_se/KAsakara/viSeRawaH/viSiRtawaH/muKyawaH/viSeRa_rUpa_se
BalI_BAMwi	BalI-BAzwi/BalI_BAzwi/BarapUra/BalIBAzwi/BalI-BAMwi/BalI_BAMwi/BalIBAMwi/sarvawoBAva/acCI_waraha
jalxI_se	jalxI/SIGra/SIGrawaH/avilaMbawaH/jalxa/acira/wUrNa/SiwAba/begi/avalaMbiwa/avalambiwa/jalxI_se/ASu/avilaMbiwa/avilambiwa
uxxeSyapUrvaka	uxxeSyapUrvaka/uxxeSyawaH/sABiprAyaH/soxxeSya
acAMcaka	acAnaka/ekAeka/sahasA/ekabAragI/ikabAragI/yakAyaka/akasmAwa/akasmAw/anAyAsa/xEvAw/xEvavaSa/Ocaka/aprawyASiwawaH/ApAwawaH/aMcakEM/agawyA/acaka/acAMcaka/acAkA/acAka/acAna/anAgawaH/anyAsa/nAgahAz/AcAna/ikahAI/ikahAU/iwwiPZAkZana/iwwiPAkana/iwwaPZAkZana/iwwaPAkana/ucakA/Ocaka
kahAz	kahAz
sAXikAra	aXikArapUrvaka/sAXikAra/aXikArawaH
TIka	bilkula/bilakula/ekaxama/nipata/sarAsara/TIka/niwAMwa/niwAnwa/pUrNawaH/pUrI_waraha_se/pUrNawayA/saMpUrNawaH/saMpUrNawayA/pUrNarupeNa/AmUlacUla/Sawa-prawiSawa/TIka-TAka/TIkaTAka/TIka/acCA/baDZiyA/TIka/TIka_se/acCI_waraha/acCI_waraha_se
ruka-ruka_kara	ruka-ruka_kara/ruka-rukakara/virAmawaH/Tahara_Tahara_kara/savirAmawaH
KZAsa_wOra_se	viSeRakara/KZAsakara/KZAsa_wOra_para/KZAsa_wOra_se/KZAsawOra_para/KZAsawOra_se/KAsawOra_para/KAsawOra_se/KAsakara/viSeRawaH/viSiRtawaH/muKyawaH/viSeRa_rUpa_se
asAlawana	svayaM/svawaH/Kuxa/KZuxa/Apa/ApahI/apaneApa/KZuxa_hI/sAkRAw/sAkRAwa/asAlawana/AparUpa
wIna_gunA	wigunA/wInagunA/wIna_gunA
kamabeSa	kamobeSa/kamabeSa/nyUnAXika
waba_hI	waBI/waba_hI/usI_samaya/usI_GadZI
xobArA	xubArA/xobArA/Pira/Pira_se/punaH/eka_bAra_Pira/vApasa_se
niSSabxa	cupacApa/cupa/mOna/SAMwa/SAnwa/KZAmoSI_se/KAmoSI_se/niSSabxa/avAka/avAk/bina_bole/mOnawaH
sAyAsa	prayawnapUrvaka/sAyAsa/prayawnawaH/prayawna_se
sarvaxA	hameSA/saxA/niwya/saxEva/niwya_prawi/sarvaxA/sarvaWA/haraxama/haravakwa/harasamaya/xina-rAwa/xinarAwa/xina_rAwa/rAwa-xina/rAwaxina/niSixina/nisa-vAsara/nisavAsara/niSivAsara/niranwara/niraMwara/anavaXi/sarvaxEva/aharaha/pinnA/aharniSa/ahorAwra
Age_pICe	AgepICe/Age_pICe/Age-pICe/pUrvApara
burI_waraha	burA/KarAba/burI_waraha
sAwagunA	sAwagunA/sawagunA
ahewu	vyarWa/PZajUla/PijUla/PZijUla/anerA/yoM_hI/vqWA/apArWa/bAxa-havAI/bAxahavAI/ahewu/ahewuka/aviraWA
bAyeM	bAez/bAez_bAjZU/bAyeM
praWamawaH	pahale_pahala/praWamawaH/sarva_praWama/sarvapraWama/SurU_meM/pahale-pahala/avvalana/pahile_pahala/pahile_pahala/AraMBa_meM/AraMBawaH/AramBawaH/pahale/SurU_meM/praWama/Axi_meM/praWamawaH/sarvapraWama/pUrva/SuruAwa_meM/SuruvAwa_meM/AramBa_meM/prAramBa_meM
viSeRa_rUpa_se	viSeRakara/KZAsakara/KZAsa_wOra_para/KZAsa_wOra_se/KZAsawOra_para/KZAsawOra_se/KAsawOra_para/KAsawOra_se/KAsakara/viSeRawaH/viSiRtawaH/muKyawaH/viSeRa_rUpa_se
uwa	uXara/usa_ora/pare/uwa/uwana
upAya_se	yukwipUrvaka/upAyawaH/upAya_se/jugawa_lagAkara/warakIba_se/warIkZe_se
karmAnusAra	yaWAkarma/karmAnusAra
svecCawaH	svecCApUrvaka/icCA_se/KZuSI_KZuSI/KZuSI_se/svecCayA/svecCawaH
usa_vakwa	waba/usa_samaya/usa_vakwa
prawikRaNa	lagAwAra/anavarawa/niraMwara/niranwara/wAbadZawodZa/xanAxana/sawawa/XUAzXAra/anaMwara/ananwara/avirAmawaH/aniSa/prawikRaNa/anukRaNa/XadZAXadZa/avirawa/muwwasila/avicCinna/avicCexa/aviSrAnwa/aviSrAMwa/asarAra/aharaha/AsaMga/Asafga/ikawAra/prawikRaNa/pala_pala/pala-pala/prawipala/hara_kRaNa/kRaNa-kRaNa/haraGadZI/hara_GadZI/prawi_kRaNa/kRaNakRaNa/anukRaNa/CinaCina/Cina-Cina/AKana
AjFAnusAra	AjFAnusAra/AxeSAnusAra
haraGadZI	prawikRaNa/pala_pala/pala-pala/prawipala/hara_kRaNa/kRaNa-kRaNa/haraGadZI/hara_GadZI/prawi_kRaNa/kRaNakRaNa/anukRaNa/CinaCina/Cina-Cina/AKana
paScAwa	bAxa/bAxa_meM/paScAw/uparAMwa/anaMwara/paScAwa/uparAnwa/ananwara/pICe/uwwara/aWa/anupaxa/anvakRa
xviguNa	xugunA/xUnA/xogunA/xuganA/xviguNa/xviguNiwa
bina_bole	cupacApa/cupa/mOna/SAMwa/SAnwa/KZAmoSI_se/KAmoSI_se/niSSabxa/avAka/avAk/bina_bole/mOnawaH
animiKa	takatakI_se/ekataka/tukura_tukura/taka-taka/animeRa/animiRa/animiKa/anamiKa/ikataka
hiwArWa	hiwArWa/kalyANArWa
prAyaSaH	prAyaH/akasara/aksara/aXikawara/aXikAMSawaH/jyAxAwara/bahuXA/AmawOra_para/AmawOra_se/aXikAMSawayA/prAyaSaH/anekaXA
sarvawoBAva	BalI-BAzwi/BalI_BAzwi/BarapUra/BalIBAzwi/BalI-BAMwi/BalI_BAMwi/BalIBAMwi/sarvawoBAva/acCI_waraha
aba	PilahAla/PZilahAla/aba/varwamAna_meM/Aja-kala/Ajakala/Aja_kala/AjakAla/ina_xinoM/isa_samaya/saMprawi/aBI/PZilahAla/PilahAla/isa_samaya/aba/aWa/aXunA/saMprawi/samprawi/aBU/aBE/aba/abakI/isabAra/aba_kI/isa_bAra/aba/Age/AinxA/AiMxA/AyaMxA/AyanxA/aba
bAsaUra	SiRtawaH/saByawaH/bAsaUra/SAlInawaH/SiRtAcArapUrvaka/salIkZe_se
binA_lAga_lapeta_ke	spaRta/spaRtawaH/Kula_kara/Kule_wOra_para/Kullama_KullA/binA_lAga_lapeta_ke/sAPZa_sAPZa/spaRtawayA/sAPZa-sAPZa/sAPa-sAPa
lagAwAra	lagAwAra/anavarawa/niraMwara/niranwara/wAbadZawodZa/xanAxana/sawawa/XUAzXAra/anaMwara/ananwara/avirAmawaH/aniSa/prawikRaNa/anukRaNa/XadZAXadZa/avirawa/muwwasila/avicCinna/avicCexa/aviSrAnwa/aviSrAMwa/asarAra/aharaha/AsaMga/Asafga/ikawAra
prasannawaH	prasannawApUrvaka/KZuSI_KZuSI/KuSI_KuSI/KZuSI_se/KuSI_se/prasannawaH/saharRa/harRapUrvaka
nAmamAwra	nAmamAwra/leSamAwra/raMcamAwra/WodZA_sA
bawOra	viXipUrvaka/kZAyaxe_se/DaMga_se/warIkZe_se/bawOra/bAkZAyaxA/viXivaw/viXivawa
kAlAMwara_meM	kAlAMwara_meM
anyawra	anyawra/kahIM_Ora/anawa
ajahuz	aba_waka/aBI_waka/Aja_waka/abawaka/aBIwaka/Ajawaka/ajahuz/ajahUz/ajo/ajOM/abalaga
avasi	niHsaMxeha/nissaMxeha/jarUra/jZarUra/niHsanxeha/nissanxeha/nisaMxeha/nisanxeha/binA_Saka/beSaka/bilkula/bilakula/yakInana/yakZInana/avaSyameva/avaSya/alabawwA/bilASaka/aBarama/vASinxA/bASinxA/avasi/aviwarkika/asaMSaya/niSciwawaH/ikaMka
baKZUbI	baKZUbI/baKUbI
isa_bAra	aba/abakI/isabAra/aba_kI/isa_bAra
IrRyApUrNawaH	IrRyApUrvaka/IrRyawaH/xveRapUrvaka/sAsUya/IrRyApUrNawaH
anaXikAra	anaXikAra/aXikArahInawaH
xveRapUrvaka	IrRyApUrvaka/IrRyawaH/xveRapUrvaka/sAsUya/IrRyApUrNawaH
iBa	yoM/yUz/Ese/isa_waraha/isa_prakAra/EsA/iwWaM/ima/imi/iBa/iva/isE/IxqS/IxqSa
saMyogavaSAw	saMyogavaSa/iwwiPZAkZana/iwwiPAkana/iwwaPZAkZana/iwwaPAkana/saMyogavaSAw
pUrvApara	AgepICe/Age_pICe/Age-pICe/pUrvApara
niwya_prawi	hameSA/saxA/niwya/saxEva/niwya_prawi/sarvaxA/sarvaWA/haraxama/haravakwa/harasamaya/xina-rAwa/xinarAwa/xina_rAwa/rAwa-xina/rAwaxina/niSixina/nisa-vAsara/nisavAsara/niSivAsara/niranwara/niraMwara/anavaXi/sarvaxEva/aharaha/pinnA/aharniSa/ahorAwra
umraBara	mqwyuparyanwa/AjIvana/wAumra/umraBara/jZiMxagIBara/jiMxagIBara/jIvanaBara/AmaraNa/aMwima_xama_waka
KZAsawOra_para	viSeRakara/KZAsakara/KZAsa_wOra_para/KZAsa_wOra_se/KZAsawOra_para/KZAsawOra_se/KAsawOra_para/KAsawOra_se/KAsakara/viSeRawaH/viSiRtawaH/muKyawaH/viSeRa_rUpa_se
pAra	pAra/xUsarI_waraPa
Apasa_meM	paraspara/Apasa_meM/eka_xUsare_se/iwarewara
lOtAnI	lOtAnI
nisa-vAsara	hameSA/saxA/niwya/saxEva/niwya_prawi/sarvaxA/sarvaWA/haraxama/haravakwa/harasamaya/xina-rAwa/xinarAwa/xina_rAwa/rAwa-xina/rAwaxina/niSixina/nisa-vAsara/nisavAsara/niSivAsara/niranwara/niraMwara/anavaXi/sarvaxEva/aharaha/pinnA/aharniSa/ahorAwra
rAwoMrAwa	rAwoM-rAwa/rAwoMrAwa
niraMwara	lagAwAra/anavarawa/niraMwara/niranwara/wAbadZawodZa/xanAxana/sawawa/XUAzXAra/anaMwara/ananwara/avirAmawaH/aniSa/prawikRaNa/anukRaNa/XadZAXadZa/avirawa/muwwasila/avicCinna/avicCexa/aviSrAnwa/aviSrAMwa/asarAra/aharaha/AsaMga/Asafga/ikawAra/hameSA/saxA/niwya/saxEva/niwya_prawi/sarvaxA/sarvaWA/haraxama/haravakwa/harasamaya/xina-rAwa/xinarAwa/xina_rAwa/rAwa-xina/rAwaxina/niSixina/nisa-vAsara/nisavAsara/niSivAsara/niranwara/niraMwara/anavaXi/sarvaxEva/aharaha/pinnA/aharniSa/ahorAwra
ikajora	sAWa-sAWa/sAWa_hI/sAWa_hI_sAWa/sAWa/eka_sAWa/ikatTA/ikajora/ekawra/ikawra
vqWA	vyarWa/PZajUla/PijUla/PZijUla/anerA/yoM_hI/vqWA/apArWa/bAxa-havAI/bAxahavAI/ahewu/ahewuka/aviraWA
yawkiMciw	jarA/jZarA/jarA-sA/jZarA-sA/rawwiBara/WodZA/WodZA-sA/WodZA_sA/wanika/yawkiMciw
KatAka_se	Jatapata/catapata/PatAPata/wuraMwa/wuranwa/wawkAla/avilaMba/avilamba/PZOrana/POrana/KatAka_se/wawkRaNa/wadZAka_se/wadZa_se/wapAka_se/awiSIGra/awiSIGrawaH/jalxa_se_jalxa/jalxI_se_jalxI/wadZa_se/hAWoM-hAWa/hAWoM_hAWa/hAWo-hAWa/hAWo_hAWa/Kata_se/Anana-PAnana_meM/AnanaPAnana_meM/siwAba/siwAbI/besAKwA/TahAkA/ikahAI/ikahAU
parasoM	parasoM/parasoM
ikawra	sAWa-sAWa/sAWa_hI/sAWa_hI_sAWa/sAWa/eka_sAWa/ikatTA/ikajora/ekawra/ikawra
KUba	bahuwa/KZUba/KUba/badZA/jyAxA/jZyAxA/aXika/kAPZI/kAPI/kadZA/jamakara/datakara
najaxIka	pAsa_meM/najZaxIka/najaxIka/nikata_meM/kZarIba_meM/samIpa/nikata/pAsa/kZarIba/karIba/sannikata/najIka/muwwasila/arvAka/avixUra/Are/AsapAsa/Asa-pAsa
uxArawApUrvaka	uxArawApUrvaka
kuSalawApUrvaka	sakuSala/kuSalawApUrvaka/kuSalapUrvaka/sahI_salAmawa/sahI-salAmawa/TIka-TAka/TIka_se/TIka-TAka_se/TIkaTAka/baKZEra/baKEra/baKZErIya/baKErIyawa/surakRiwawaH
bagEra	binA/bagZEra/bagEra
cupacApa	cupacApa/cupa/mOna/SAMwa/SAnwa/KZAmoSI_se/KAmoSI_se/niSSabxa/avAka/avAk/bina_bole/mOnawaH
jyoM-jyoM	jEse-jEse/jyoM-jyoM
sAPZa-sAPZa	spaRta/spaRtawaH/Kula_kara/Kule_wOra_para/Kullama_KullA/binA_lAga_lapeta_ke/sAPZa_sAPZa/spaRtawayA/sAPZa-sAPZa/sAPa-sAPa
sacamuca	vAkaI/vAkZaI/vAswava_meM/hakIkawana/hakZIkZawana/xaraasala/asala_meM/sacamuca/saccI-muccI/saccI_muccI/sawyawaH/vaswuwaH
saMkalpapUrvaka	saMkalpapUrvaka/irAxawana/irAxe_se/xqDZawApUrvaka/niScayapUrvaka
BalI-BAMwi	BalI-BAzwi/BalI_BAzwi/BarapUra/BalIBAzwi/BalI-BAMwi/BalI_BAMwi/BalIBAMwi/sarvawoBAva/acCI_waraha
AmUlacUla	bilkula/bilakula/ekaxama/nipata/sarAsara/TIka/niwAMwa/niwAnwa/pUrNawaH/pUrI_waraha_se/pUrNawayA/saMpUrNawaH/saMpUrNawayA/pUrNarupeNa/AmUlacUla/Sawa-prawiSawa
prayojanahInawaH	akAraNa/prayojanahInawaH/Ese_hI/yUz_hI/kAraNahInawaH/bevajaha/uxxeSyahInawaH
rimaJima-rimaJima	rimaJima/rimaJima-rimaJima/rima-Jima
anahaka	vyarWa_hI/yoM_hI/JUTa-mUTa/yOM_hI/yUz_hI/Ese_hI/nAhakZa/nAhaka/PZajZUla/PajUla/PZijZUla/PijUla/anahaka/anAhaka
SiwAba	jalxI/SIGra/SIGrawaH/avilaMbawaH/jalxa/acira/wUrNa/SiwAba/begi/avalaMbiwa/avalambiwa/jalxI_se/ASu/avilaMbiwa/avilambiwa
rAwaxina	hameSA/saxA/niwya/saxEva/niwya_prawi/sarvaxA/sarvaWA/haraxama/haravakwa/harasamaya/xina-rAwa/xinarAwa/xina_rAwa/rAwa-xina/rAwaxina/niSixina/nisa-vAsara/nisavAsara/niSivAsara/niranwara/niraMwara/anavaXi/sarvaxEva/aharaha/pinnA/aharniSa/ahorAwra
Ajanma	Ajanma/jIvanaparyanwa/jIvanaBara
gumasuma	gumasuma
aXikAMSawaH	aXikawaH/aXikAMSawaH/prAyaH/aXikAMSawayA/prAyaH/akasara/aksara/aXikawara/aXikAMSawaH/jyAxAwara/bahuXA/AmawOra_para/AmawOra_se/aXikAMSawayA/prAyaSaH/anekaXA
nirnimeRa	apalaka/nirnimeRa/nirnimiRa/nirnimeKa
muSkila_se	kaTinAI_se/jEse_wEse/muSkila_se/bamuSkila/kaTinawaH/nITi
Upara	Upara/Upara/UzcAI_para/UrxXva/UrXva/Upara/AXAra_para/Upara/aXika/jyAxA/jZyAxA/Upara_se/Upara/Upara
baKEra	sakuSala/kuSalawApUrvaka/kuSalapUrvaka/sahI_salAmawa/sahI-salAmawa/TIka-TAka/TIka_se/TIka-TAka_se/TIkaTAka/baKZEra/baKEra/baKZErIya/baKErIyawa/surakRiwawaH
AmawOra_para	prAyaH/akasara/aksara/aXikawara/aXikAMSawaH/jyAxAwara/bahuXA/AmawOra_para/AmawOra_se/aXikAMSawayA/prAyaSaH/anekaXA
viXihInawaH	viXihInawaH/kuviXipUrvaka/bewarIkZe
niSixina	hameSA/saxA/niwya/saxEva/niwya_prawi/sarvaxA/sarvaWA/haraxama/haravakwa/harasamaya/xina-rAwa/xinarAwa/xina_rAwa/rAwa-xina/rAwaxina/niSixina/nisa-vAsara/nisavAsara/niSivAsara/niranwara/niraMwara/anavaXi/sarvaxEva/aharaha/pinnA/aharniSa/ahorAwra
AxyAMwa	AxyopAMwa/AxyopAnwa/AxyAMwa/AxyAnwa
KZAmoSI_se	cupacApa/cupa/mOna/SAMwa/SAnwa/KZAmoSI_se/KAmoSI_se/niSSabxa/avAka/avAk/bina_bole/mOnawaH
BaviRya_kAla_meM	BaviRya_meM/Age/BaviRya_kAla_meM/agawyA
nArAjagIpUrvaka	aprasannawApUrvaka/nArAjZagIpUrvaka/nAKZuSI_se/nArAjagIpUrvaka/nAKuSI_se
Aja-kala	PilahAla/PZilahAla/aba/varwamAna_meM/Aja-kala/Ajakala/Aja_kala/AjakAla/ina_xinoM/isa_samaya/saMprawi
acAna	acAnaka/ekAeka/sahasA/ekabAragI/ikabAragI/yakAyaka/akasmAwa/akasmAw/anAyAsa/xEvAw/xEvavaSa/Ocaka/aprawyASiwawaH/ApAwawaH/aMcakEM/agawyA/acaka/acAMcaka/acAkA/acAka/acAna/anAgawaH/anyAsa/nAgahAz/AcAna/ikahAI/ikahAU/iwwiPZAkZana/iwwiPAkana/iwwaPZAkZana/iwwaPAkana/ucakA/Ocaka
bArambAra	bAra-bAra/bAra_bAra/bAraMbAra/bArambAra/asakqwa/ahora-bahora
hU-ba-hU	prawirUpawaH/hUbahU/hU-ba-hU
baDZiyA	TIka-TAka/TIkaTAka/TIka/acCA/baDZiyA/acCA/baDZiyA/acCI_waraha/acCI_waraha_se/tanAtana
prawixina	prawixina/haraxina/niwya/hararojZa/rojZa/niwa/roja/rojZAnA/rojAnA/anuxina/niwyaprawi/anuxivasa/aharaha
COgunA	CahagunA/COgunA/CaHgunA
kisa_prakAra_se	kEse/kisa_prakAra_se
aXikArawaH	aXikArapUrvaka/sAXikAra/aXikArawaH
yaWAvaw	yaWAvaw/yaWAvawa
yahAz	yahAz/isa_jagaha/iwaH/iwa/iha/ihAz/ihavAz/IMGe/IhAz
cupake_se	cupake_se/cupake-cupake/xaraparaxA
Upara_se	Upara_se/Upara
jEse-wEse	jEse-wEse
anAgawaH	acAnaka/ekAeka/sahasA/ekabAragI/ikabAragI/yakAyaka/akasmAwa/akasmAw/anAyAsa/xEvAw/xEvavaSa/Ocaka/aprawyASiwawaH/ApAwawaH/aMcakEM/agawyA/acaka/acAMcaka/acAkA/acAka/acAna/anAgawaH/anyAsa/nAgahAz/AcAna/ikahAI/ikahAU/iwwiPZAkZana/iwwiPAkana/iwwaPZAkZana/iwwaPAkana/ucakA/Ocaka
surakRiwawaH	sakuSala/kuSalawApUrvaka/kuSalapUrvaka/sahI_salAmawa/sahI-salAmawa/TIka-TAka/TIka_se/TIka-TAka_se/TIkaTAka/baKZEra/baKEra/baKZErIya/baKErIyawa/surakRiwawaH
bAxa-havAI	vyarWa/PZajUla/PijUla/PZijUla/anerA/yoM_hI/vqWA/apArWa/bAxa-havAI/bAxahavAI/ahewu/ahewuka/aviraWA
basa	basa/alam/alaM/akelA/akele/kevala/sirPZa/mAwra/KAlI/KZAlI/basa/nipata/mahajZa/sirPa/wanhA/wanahA/ekAkI/ekameva/ekaMga/ikelA
aso	aso/asoM/AsO/isa_varRa/isa_sAla
aXimAnawaH	aXimAnawaH/varIyawA_se/acCA_ho_ki
bemawalaba	akAraNa/bemawalaba/niRkAraNa/kAraNahInawaH/animiwwa
uBayawaH	uBayawaH
samAnAnwara	samAMwara/samAnAMwara/samAnwara/samAnAnwara
cupa	cupacApa/cupa/mOna/SAMwa/SAnwa/KZAmoSI_se/KAmoSI_se/niSSabxa/avAka/avAk/bina_bole/mOnawaH
PZOrana	Jatapata/catapata/PatAPata/wuraMwa/wuranwa/wawkAla/avilaMba/avilamba/PZOrana/POrana/KatAka_se/wawkRaNa/wadZAka_se/wadZa_se/wapAka_se/awiSIGra/awiSIGrawaH/jalxa_se_jalxa/jalxI_se_jalxI/wadZa_se/hAWoM-hAWa/hAWoM_hAWa/hAWo-hAWa/hAWo_hAWa/Kata_se/Anana-PAnana_meM/AnanaPAnana_meM/siwAba/siwAbI/besAKwA/TahAkA/ikahAI/ikahAU
wawkAla	Jatapata/catapata/PatAPata/wuraMwa/wuranwa/wawkAla/avilaMba/avilamba/PZOrana/POrana/KatAka_se/wawkRaNa/wadZAka_se/wadZa_se/wapAka_se/awiSIGra/awiSIGrawaH/jalxa_se_jalxa/jalxI_se_jalxI/wadZa_se/hAWoM-hAWa/hAWoM_hAWa/hAWo-hAWa/hAWo_hAWa/Kata_se/Anana-PAnana_meM/AnanaPAnana_meM/siwAba/siwAbI/besAKwA/TahAkA/ikahAI/ikahAU
isa_ora	iXara/isa_ora/yahAz_para/iwaH/iwa/iwE/iwWe
anvakRa	sAmane/Age/samakRa/sammuKa/agre/anvakRa/aBimuKa/xarapeSa/Agala/AgalA/bAxa/bAxa_meM/paScAw/uparAMwa/anaMwara/paScAwa/uparAnwa/ananwara/pICe/uwwara/aWa/anupaxa/anvakRa
axya	Aja/axya
kRaNakRaNa	prawikRaNa/pala_pala/pala-pala/prawipala/hara_kRaNa/kRaNa-kRaNa/haraGadZI/hara_GadZI/prawi_kRaNa/kRaNakRaNa/anukRaNa/CinaCina/Cina-Cina/AKana
Kula_kara	spaRta/spaRtawaH/Kula_kara/Kule_wOra_para/Kullama_KullA/binA_lAga_lapeta_ke/sAPZa_sAPZa/spaRtawayA/sAPZa-sAPZa/sAPa-sAPa
jarA-sA	jarA/jZarA/jarA-sA/jZarA-sA/rawwiBara/WodZA/WodZA-sA/WodZA_sA/wanika/yawkiMciw
pare	uXara/usa_ora/pare/uwa/uwana/xUra/xUrI_para/alaga/pare/pare/Age/bAxa/pare
saharRa	prasannawApUrvaka/KZuSI_KZuSI/KuSI_KuSI/KZuSI_se/KuSI_se/prasannawaH/saharRa/harRapUrvaka
jarUra	niHsaMxeha/nissaMxeha/jarUra/jZarUra/niHsanxeha/nissanxeha/nisaMxeha/nisanxeha/binA_Saka/beSaka/bilkula/bilakula/yakInana/yakZInana/avaSyameva/avaSya/alabawwA/bilASaka/aBarama/vASinxA/bASinxA/avasi/aviwarkika/asaMSaya/niSciwawaH/ikaMka/avaSya/jarUra/jZarUra
Tahara_Tahara_kara	ruka-ruka_kara/ruka-rukakara/virAmawaH/Tahara_Tahara_kara/savirAmawaH
usa_samaya	waba/usa_samaya/usa_vakwa
yaWAkRama	yaWASakwi/Barasaka/yaWAsAXya/yaWAsaMBava/kRamawAnusAra/yaWAkRama
niruxxeSya	uxxeSyahInawaH/niruxxeSya/niruxxeSyawaH
samayAnusAra	samayAnusAra/yaWAsamaya/sasamaya
usa_waraha	vEse/vEsA/usI_waraha/usa_waraha/iva
isa_xOrAna	iwane_meM/isa_bIca/isI_bIca/isa_xOrAna/isa_xaramyAna
saSarIra	saxeha/saSarIra
IrRyawaH	IrRyApUrvaka/IrRyawaH/xveRapUrvaka/sAsUya/IrRyApUrNawaH
WodZA	jarA/jZarA/jarA-sA/jZarA-sA/rawwiBara/WodZA/WodZA-sA/WodZA_sA/wanika/yawkiMciw
hararojZa	prawixina/haraxina/niwya/hararojZa/rojZa/niwa/roja/rojZAnA/rojAnA/anuxina/niwyaprawi/anuxivasa/aharaha
ekawra	sAWa-sAWa/sAWa_hI/sAWa_hI_sAWa/sAWa/eka_sAWa/ikatTA/ikajora/ekawra/ikawra
jZarUra	niHsaMxeha/nissaMxeha/jarUra/jZarUra/niHsanxeha/nissanxeha/nisaMxeha/nisanxeha/binA_Saka/beSaka/bilkula/bilakula/yakInana/yakZInana/avaSyameva/avaSya/alabawwA/bilASaka/aBarama/vASinxA/bASinxA/avasi/aviwarkika/asaMSaya/niSciwawaH/ikaMka/avaSya/jarUra/jZarUra
Osawana	Osawana
sAwaMka	AwaMkapUrvaka/sAwaMka
aksara	prAyaH/akasara/aksara/aXikawara/aXikAMSawaH/jyAxAwara/bahuXA/AmawOra_para/AmawOra_se/aXikAMSawayA/prAyaSaH/anekaXA
Aja	Aja/axya
cUdZAMwa	awyaMwa/awyanwa/awyaXika/be-iMwahA/beiMwahA/bahuwa_aXika/bahuwa_hI/bepanAha/saKZwa/saKwa/jamakara/mahA/nihAyawa/cUdZAMwa/cUdZAnwa/aByaXika/Agara
vakAlawana	vakAlawana
xUsarI_waraPa	pAra/xUsarI_waraPa
kZAyaxe_se	viXipUrvaka/kZAyaxe_se/DaMga_se/warIkZe_se/bawOra/bAkZAyaxA/viXivaw/viXivawa
isa_jagaha	yahAz/isa_jagaha/iwaH/iwa/iha/ihAz/ihavAz/IMGe/IhAz
uparAMwa	bAxa/bAxa_meM/paScAw/uparAMwa/anaMwara/paScAwa/uparAnwa/ananwara/pICe/uwwara/aWa/anupaxa/anvakRa
alpaSaH	alpawaH/WodZA-WodZA/WodZA_WodZA/alpaSaH/kramaSaH/kramAnusAra/yaWAkrama/silasilevAra/bArI-bArI_se/kramavAra/warawIbavAra/ayugapaxa/alpaSaH/XIre-XIre/XIre_XIre/Ahiswe-Ahiswe/AhiswA-AhiswA/hOle-hOle/hole-hole/raPwA-raPwA/alpaSaH
yaWAsamaya	samayAnusAra/yaWAsamaya/sasamaya
galawa_vakwa_para	kusamaya/gZalawa_vakZwa_para/asamaya/bevakZwa/galawa_vakwa_para/bevakwa/bemOke
aMXaXuMXa	aMXAXuMXa/bewahASA/anXAXunXa/aMXaXuMXa/anXaXunXa/utakkara
kisalie	kyoM/kisalie/kisa_vAswe
SAMwa	cupacApa/cupa/mOna/SAMwa/SAnwa/KZAmoSI_se/KAmoSI_se/niSSabxa/avAka/avAk/bina_bole/mOnawaH
syaw	saMBavawaH/SAyaxa/syaw
KZuSI_KZuSI	svecCApUrvaka/icCA_se/KZuSI_KZuSI/KZuSI_se/svecCayA/svecCawaH/prasannawApUrvaka/KZuSI_KZuSI/KuSI_KuSI/KZuSI_se/KuSI_se/prasannawaH/saharRa/harRapUrvaka
krUrawApUrvaka	nirxayawApUrvaka/nirxayawA_se/berahamI_se/bexarxI_se/krUrawApUrvaka/barbarawApUrvaka/kaTorawA_se/kadZAI_se
vApasa	vApasa/vApisa
sarvapraWama	pahale_pahala/praWamawaH/sarva_praWama/sarvapraWama/SurU_meM/pahale-pahala/avvalana/pahile_pahala/pahile_pahala/AraMBa_meM/AraMBawaH/AramBawaH/pahale/SurU_meM/praWama/Axi_meM/praWamawaH/sarvapraWama/pUrva/SuruAwa_meM/SuruvAwa_meM/AramBa_meM/prAramBa_meM
spaRta	spaRta/spaRtawaH/Kula_kara/Kule_wOra_para/Kullama_KullA/binA_lAga_lapeta_ke/sAPZa_sAPZa/spaRtawayA/sAPZa-sAPZa/sAPa-sAPa
anawa	anyawra/kahIM_Ora/anawa
ikaMka	niHsaMxeha/nissaMxeha/jarUra/jZarUra/niHsanxeha/nissanxeha/nisaMxeha/nisanxeha/binA_Saka/beSaka/bilkula/bilakula/yakInana/yakZInana/avaSyameva/avaSya/alabawwA/bilASaka/aBarama/vASinxA/bASinxA/avasi/aviwarkika/asaMSaya/niSciwawaH/ikaMka
hasbe-mAmUla	hasbemAmUla/hasbe-mAmUla/hasba-e-mAmUla/hameSA_kI_waraha
kahUz	kahIM/kahUz/kahuz/kahIM/kahUz/kahuz
Cinna-Binna	wiwara-biwara/aswa-vyaswa/Cinna-Binna/bewarawIba/aswavyaswa/_avyavasWiwa
jarA	jarA/jZarA/jarA-sA/jZarA-sA/rawwiBara/WodZA/WodZA-sA/WodZA_sA/wanika/yawkiMciw
samakRa	sAmane/Age/samakRa/sammuKa/agre/anvakRa/aBimuKa/xarapeSa/Agala/AgalA
niSciMwawaH	niSciMwawaH/ciMwAhInawaH/beKatake
avilaMbiwa	jalxI/SIGra/SIGrawaH/avilaMbawaH/jalxa/acira/wUrNa/SiwAba/begi/avalaMbiwa/avalambiwa/jalxI_se/ASu/avilaMbiwa/avilambiwa
KAmoSI_se	cupacApa/cupa/mOna/SAMwa/SAnwa/KZAmoSI_se/KAmoSI_se/niSSabxa/avAka/avAk/bina_bole/mOnawaH
hAWa_xvArA	hAWa_se/hAWa_xvArA/haswacAliwa_DaMga_se/haswacAlana_xvArA
binA_pariSrama	anAyAsa/binA_pariSrama/aprayawnawaH/prayawnahInawaH/ayAsa
bagaCuta	bagaCuta/bagatuta
yaWAparAXa	yaWAparAXa/aparAXAnusAra
kasakara	kasakara/joraxAra/weja/wejZa/wIvra/wejZI_se/jZora_se/wejI_se/jora_se/wIvrawA_se
ApAwawaH	acAnaka/ekAeka/sahasA/ekabAragI/ikabAragI/yakAyaka/akasmAwa/akasmAw/anAyAsa/xEvAw/xEvavaSa/Ocaka/aprawyASiwawaH/ApAwawaH/aMcakEM/agawyA/acaka/acAMcaka/acAkA/acAka/acAna/anAgawaH/anyAsa/nAgahAz/AcAna/ikahAI/ikahAU/iwwiPZAkZana/iwwiPAkana/iwwaPZAkZana/iwwaPAkana/ucakA/Ocaka
vahAz	vahAz/usa_jagaha
BUwa_meM	awIwa_meM/pahale/BUwa_meM/BUwa_kAla_meM/pICe/piCale_xinoM_meM
wAumra	mqwyuparyanwa/AjIvana/wAumra/umraBara/jZiMxagIBara/jiMxagIBara/jIvanaBara/AmaraNa/aMwima_xama_waka
haravakwa	hameSA/saxA/niwya/saxEva/niwya_prawi/sarvaxA/sarvaWA/haraxama/haravakwa/harasamaya/xina-rAwa/xinarAwa/xina_rAwa/rAwa-xina/rAwaxina/niSixina/nisa-vAsara/nisavAsara/niSivAsara/niranwara/niraMwara/anavaXi/sarvaxEva/aharaha/pinnA/aharniSa/ahorAwra
xaSa_gunA	xasagunA/xaSagunA/xasa_gunA/xaSa_gunA
kaBIkaBI	kaBIkaBI/kaBIkaBAra/yaxAkaxA/kaBI-kaBI/kaBI-kaBAra/yaxA-kaxA/vakwan-POvakwan
WodZA-sA	jarA/jZarA/jarA-sA/jZarA-sA/rawwiBara/WodZA/WodZA-sA/WodZA_sA/wanika/yawkiMciw
awyanwa	awyaMwa/awyanwa/awyaXika/be-iMwahA/beiMwahA/bahuwa_aXika/bahuwa_hI/bepanAha/saKZwa/saKwa/jamakara/mahA/nihAyawa/cUdZAMwa/cUdZAnwa/aByaXika/Agara
asoM	aso/asoM/AsO/isa_varRa/isa_sAla
akasmAw	acAnaka/ekAeka/sahasA/ekabAragI/ikabAragI/yakAyaka/akasmAwa/akasmAw/anAyAsa/xEvAw/xEvavaSa/Ocaka/aprawyASiwawaH/ApAwawaH/aMcakEM/agawyA/acaka/acAMcaka/acAkA/acAka/acAna/anAgawaH/anyAsa/nAgahAz/AcAna/ikahAI/ikahAU/iwwiPZAkZana/iwwiPAkana/iwwaPZAkZana/iwwaPAkana/ucakA/Ocaka
avilaMba	Jatapata/catapata/PatAPata/wuraMwa/wuranwa/wawkAla/avilaMba/avilamba/PZOrana/POrana/KatAka_se/wawkRaNa/wadZAka_se/wadZa_se/wapAka_se/awiSIGra/awiSIGrawaH/jalxa_se_jalxa/jalxI_se_jalxI/wadZa_se/hAWoM-hAWa/hAWoM_hAWa/hAWo-hAWa/hAWo_hAWa/Kata_se/Anana-PAnana_meM/AnanaPAnana_meM/siwAba/siwAbI/besAKwA/TahAkA/ikahAI/ikahAU
ikelA	akelA/akele/kevala/sirPZa/mAwra/KAlI/KZAlI/basa/nipata/mahajZa/sirPa/wanhA/wanahA/ekAkI/ekameva/ekaMga/ikelA
bArI-bArI_se	kramaSaH/kramAnusAra/yaWAkrama/silasilevAra/bArI-bArI_se/kramavAra/warawIbavAra/ayugapaxa/alpaSaH
lagaBaga	aMxAjana/aMxAjZana/anxAjZana/anxAjana/lagaBaga/wakZarIbana/wakarIbana/kZarIba/karIba/karIbakarIba/karIbana/kZarIbakZarIba/kZarIbana/anumAnawaH/anakZarIba/anakarIba/waKZamInana/aMxAja_se/ukavAz
kaTorawA_se	nirxayawApUrvaka/nirxayawA_se/berahamI_se/bexarxI_se/krUrawApUrvaka/barbarawApUrvaka/kaTorawA_se/kadZAI_se
pUrvavawa	pUrvavaw/pUrvavawa
XarmArWa	XarmArWa
girawe-padZawe	girawe_padZawe/girawe-padZawe
AsapAsa	pAsa_meM/najZaxIka/najaxIka/nikata_meM/kZarIba_meM/samIpa/nikata/pAsa/kZarIba/karIba/sannikata/najIka/muwwasila/arvAka/avixUra/Are/AsapAsa/Asa-pAsa/Asa-pAsa/AsapAsa/agala-bagala/agZala-bagZala/AjU-bAjU/irxa-girxa/adZosa-padZosa/pAsa-padZosa/pAsa_padZosa
eka_waraPZa	eka_ora/eka_waraPa/eka_waraPZa/xarakinAra/xUra/alaga/eka_waraPZa/eka_ora/alahaxA
aMxAja_se	aMxAjana/aMxAjZana/anxAjZana/anxAjana/lagaBaga/wakZarIbana/wakarIbana/kZarIba/karIba/karIbakarIba/karIbana/kZarIbakZarIba/kZarIbana/anumAnawaH/anakZarIba/anakarIba/waKZamInana/aMxAja_se/ukavAz
viSiRtawaH	viSeRakara/KZAsakara/KZAsa_wOra_para/KZAsa_wOra_se/KZAsawOra_para/KZAsawOra_se/KAsawOra_para/KAsawOra_se/KAsakara/viSeRawaH/viSiRtawaH/muKyawaH/viSeRa_rUpa_se
saMyogavaSa	saMyogavaSa/iwwiPZAkZana/iwwiPAkana/iwwaPZAkZana/iwwaPAkana/saMyogavaSAw
ahewuka	vyarWa/PZajUla/PijUla/PZijUla/anerA/yoM_hI/vqWA/apArWa/bAxa-havAI/bAxahavAI/ahewu/ahewuka/aviraWA
xaSagunA	xasagunA/xaSagunA/xasa_gunA/xaSa_gunA
anXAXunXa	aMXAXuMXa/bewahASA/anXAXunXa/aMXaXuMXa/anXaXunXa/utakkara
waBI	waBI/waba_hI/usI_samaya/usI_GadZI/waBI/isI_kAraNa
joraSora_se	jZora-Sora_se/jora-Sora_se/jZoraSora_se/joraSora_se/jZoroM_se/joroM_se
jZarA-sA	jarA/jZarA/jarA-sA/jZarA-sA/rawwiBara/WodZA/WodZA-sA/WodZA_sA/wanika/yawkiMciw
jEse-jEse	jEse-jEse/jyoM-jyoM
ajOM	aba_waka/aBI_waka/Aja_waka/abawaka/aBIwaka/Ajawaka/ajahuz/ajahUz/ajo/ajOM/abalaga
anasoce	vicArahInawaH/anasoce/besoce_samaJe
aprawIRa	anusAra/mAPika/muwAbika/anukUla/muAPZikZa/muAPika/muwAbikZa/aprawIRa
kevala	akelA/akele/kevala/sirPZa/mAwra/KAlI/KZAlI/basa/nipata/mahajZa/sirPa/wanhA/wanahA/ekAkI/ekameva/ekaMga/ikelA
KZUba	bahuwa/KZUba/KUba/badZA/jyAxA/jZyAxA/aXika/kAPZI/kAPI/kadZA/jamakara/datakara
AsaMga	lagAwAra/anavarawa/niraMwara/niranwara/wAbadZawodZa/xanAxana/sawawa/XUAzXAra/anaMwara/ananwara/avirAmawaH/aniSa/prawikRaNa/anukRaNa/XadZAXadZa/avirawa/muwwasila/avicCinna/avicCexa/aviSrAnwa/aviSrAMwa/asarAra/aharaha/AsaMga/Asafga/ikawAra
XadZAXadZa	lagAwAra/anavarawa/niraMwara/niranwara/wAbadZawodZa/xanAxana/sawawa/XUAzXAra/anaMwara/ananwara/avirAmawaH/aniSa/prawikRaNa/anukRaNa/XadZAXadZa/avirawa/muwwasila/avicCinna/avicCexa/aviSrAnwa/aviSrAMwa/asarAra/aharaha/AsaMga/Asafga/ikawAra/XadZAXadZa
ikawAra	lagAwAra/anavarawa/niraMwara/niranwara/wAbadZawodZa/xanAxana/sawawa/XUAzXAra/anaMwara/ananwara/avirAmawaH/aniSa/prawikRaNa/anukRaNa/XadZAXadZa/avirawa/muwwasila/avicCinna/avicCexa/aviSrAnwa/aviSrAMwa/asarAra/aharaha/AsaMga/Asafga/ikawAra
xinoMxina	xina-prawixina/xina-xina/xina-para-xina/xina-baxina/xina-ba_xina/xinaprawixina/xinaxina/xinabaxina/xinoM-xina/xinoMxina
waxoparAMwa	wawapaScAwa/waxanaMwara/waxauparAMwa/waxoparAMwa/waxaMwara/waxananwara/waxuparAMwa/waxuparAnwa/waxoparAMwa/waxoparAnwa/waxanwara/wawapaScAwa/waxanaMwara/waxauparAMwa/waxoparAMwa/waxaMwara/waxananwara/waxuparAMwa/waxuparAnwa/waxoparAMwa/waxoparAnwa/waxanwara
viSeRakara	viSeRakara/KZAsakara/KZAsa_wOra_para/KZAsa_wOra_se/KZAsawOra_para/KZAsawOra_se/KAsawOra_para/KAsawOra_se/KAsakara/viSeRawaH/viSiRtawaH/muKyawaH/viSeRa_rUpa_se
ikabAragI	acAnaka/ekAeka/sahasA/ekabAragI/ikabAragI/yakAyaka/akasmAwa/akasmAw/anAyAsa/xEvAw/xEvavaSa/Ocaka/aprawyASiwawaH/ApAwawaH/aMcakEM/agawyA/acaka/acAMcaka/acAkA/acAka/acAna/anAgawaH/anyAsa/nAgahAz/AcAna/ikahAI/ikahAU/iwwiPZAkZana/iwwiPAkana/iwwaPZAkZana/iwwaPAkana/ucakA/Ocaka
petakEyAz	pata/patta/petakEyAz
bAhara	bAhara/bAhara/bAhara
karIne_se	warIkZe_se/warIke_se/warawIba_se/kZarIne_se/karIne_se/vyavasWApUrvaka/vyavasWiwawaH/kZarInAvAra/karInAvAra
aMxara	aMxara/anxara/BIwara/aMxara/anxara/BIwara
kisa_vAswe	kyoM/kisalie/kisa_vAswe
asala_meM	vAkaI/vAkZaI/vAswava_meM/hakIkawana/hakZIkZawana/xaraasala/asala_meM/sacamuca/saccI-muccI/saccI_muccI/sawyawaH/vaswuwaH
TusATusa	TasATasa/TuzsATuzsa/KacAKaca/TusATusa
bevakZwa	kusamaya/gZalawa_vakZwa_para/asamaya/bevakZwa/galawa_vakwa_para/bevakwa/bemOke/asamaya/bevakZwa/bevakwa/gZalawa_samaya_para/galawa_samaya_para/bemOke
aprayawnawaH	anAyAsa/binA_pariSrama/aprayawnawaH/prayawnahInawaH/ayAsa
AhiswA_se	XIre/XIme/hOle/Ahiswe/AhiswA/Ahiswe_se/AhiswA_se/Asawe/Aswe
aharaha	lagAwAra/anavarawa/niraMwara/niranwara/wAbadZawodZa/xanAxana/sawawa/XUAzXAra/anaMwara/ananwara/avirAmawaH/aniSa/prawikRaNa/anukRaNa/XadZAXadZa/avirawa/muwwasila/avicCinna/avicCexa/aviSrAnwa/aviSrAMwa/asarAra/aharaha/AsaMga/Asafga/ikawAra/prawixina/haraxina/niwya/hararojZa/rojZa/niwa/roja/rojZAnA/rojAnA/anuxina/niwyaprawi/anuxivasa/aharaha/hameSA/saxA/niwya/saxEva/niwya_prawi/sarvaxA/sarvaWA/haraxama/haravakwa/harasamaya/xina-rAwa/xinarAwa/xina_rAwa/rAwa-xina/rAwaxina/niSixina/nisa-vAsara/nisavAsara/niSivAsara/niranwara/niraMwara/anavaXi/sarvaxEva/aharaha/pinnA/aharniSa/ahorAwra
cuswI_se	sPUrwipUrvaka/cuswI_se/PurwI_se/muswExI_se
SAyaxa	saMBavawaH/SAyaxa/syaw
sasamaya	samayAnusAra/yaWAsamaya/sasamaya
avilamba	Jatapata/catapata/PatAPata/wuraMwa/wuranwa/wawkAla/avilaMba/avilamba/PZOrana/POrana/KatAka_se/wawkRaNa/wadZAka_se/wadZa_se/wapAka_se/awiSIGra/awiSIGrawaH/jalxa_se_jalxa/jalxI_se_jalxI/wadZa_se/hAWoM-hAWa/hAWoM_hAWa/hAWo-hAWa/hAWo_hAWa/Kata_se/Anana-PAnana_meM/AnanaPAnana_meM/siwAba/siwAbI/besAKwA/TahAkA/ikahAI/ikahAU
SeKI_mArawe_hue	SeKI_mArawe_hue/dIMga_mArawe_hue
nIce	nIce/aXaH/nimnawaH/aXo_xiSA_meM/wale/nIce
anukRaNa	lagAwAra/anavarawa/niraMwara/niranwara/wAbadZawodZa/xanAxana/sawawa/XUAzXAra/anaMwara/ananwara/avirAmawaH/aniSa/prawikRaNa/anukRaNa/XadZAXadZa/avirawa/muwwasila/avicCinna/avicCexa/aviSrAnwa/aviSrAMwa/asarAra/aharaha/AsaMga/Asafga/ikawAra/prawikRaNa/pala_pala/pala-pala/prawipala/hara_kRaNa/kRaNa-kRaNa/haraGadZI/hara_GadZI/prawi_kRaNa/kRaNakRaNa/anukRaNa/CinaCina/Cina-Cina/AKana
mAwra	akelA/akele/kevala/sirPZa/mAwra/KAlI/KZAlI/basa/nipata/mahajZa/sirPa/wanhA/wanahA/ekAkI/ekameva/ekaMga/ikelA
bAxa_meM	bAxa/bAxa_meM/paScAw/uparAMwa/anaMwara/paScAwa/uparAnwa/ananwara/pICe/uwwara/aWa/anupaxa/anvakRa
waba_BI	Pira_BI/waWApi/waba_BI
pUrI_waraha_se	bilkula/bilakula/ekaxama/nipata/sarAsara/TIka/niwAMwa/niwAnwa/pUrNawaH/pUrI_waraha_se/pUrNawayA/saMpUrNawaH/saMpUrNawayA/pUrNarupeNa/AmUlacUla/Sawa-prawiSawa
AinxA	aba/Age/AinxA/AiMxA/AyaMxA/AyanxA
nITi	kaTinAI_se/jEse_wEse/muSkila_se/bamuSkila/kaTinawaH/nITi
kahIM_Ora	anyawra/kahIM_Ora/anawa
sAkRAw	svayaM/svawaH/Kuxa/KZuxa/Apa/ApahI/apaneApa/KZuxa_hI/sAkRAw/sAkRAwa/asAlawana/AparUpa
aXikAMSawayA	aXikawaH/aXikAMSawaH/prAyaH/aXikAMSawayA/prAyaH/akasara/aksara/aXikawara/aXikAMSawaH/jyAxAwara/bahuXA/AmawOra_para/AmawOra_se/aXikAMSawayA/prAyaSaH/anekaXA
cAra_gunA	cOgunA/cAra_gunA/cAragunA/cawurguNa
sAvaXAnI_se	sAvaXAnIpUrvaka/XyAnapUrvaka/XyAna_se/sAvaXAnI_se/sAvaXAnawaH/samBAlakara/saMBAlakara
pahale	awIwa_meM/pahale/BUwa_meM/BUwa_kAla_meM/pICe/piCale_xinoM_meM/AraMBa_meM/AraMBawaH/AramBawaH/pahale/SurU_meM/praWama/Axi_meM/praWamawaH/sarvapraWama/pUrva/SuruAwa_meM/SuruvAwa_meM/AramBa_meM/prAramBa_meM/pahale
viXAnawaH	kZAnUnana/kAnUnana/viXAnawaH
AxyopAnwa	AxyopAMwa/AxyopAnwa/AxyAMwa/AxyAnwa
kahe_muwAbikZa	kaWanAnusAra/kahanAnusAra/kahe_muwAbika/kahe_muwAbikZa/kahe_anusAra
yakZInana	niHsaMxeha/nissaMxeha/jarUra/jZarUra/niHsanxeha/nissanxeha/nisaMxeha/nisanxeha/binA_Saka/beSaka/bilkula/bilakula/yakInana/yakZInana/avaSyameva/avaSya/alabawwA/bilASaka/aBarama/vASinxA/bASinxA/avasi/aviwarkika/asaMSaya/niSciwawaH/ikaMka
jyAxAwara	prAyaH/akasara/aksara/aXikawara/aXikAMSawaH/jyAxAwara/bahuXA/AmawOra_para/AmawOra_se/aXikAMSawayA/prAyaSaH/anekaXA
KuSI_KuSI	prasannawApUrvaka/KZuSI_KZuSI/KuSI_KuSI/KZuSI_se/KuSI_se/prasannawaH/saharRa/harRapUrvaka
xUrI_para	xUra/xUrI_para/alaga/pare
isa_varRa	aso/asoM/AsO/isa_varRa/isa_sAla
xugunA	xugunA/xUnA/xogunA/xuganA/xviguNa/xviguNiwa
aviSrAnwa	lagAwAra/anavarawa/niraMwara/niranwara/wAbadZawodZa/xanAxana/sawawa/XUAzXAra/anaMwara/ananwara/avirAmawaH/aniSa/prawikRaNa/anukRaNa/XadZAXadZa/avirawa/muwwasila/avicCinna/avicCexa/aviSrAnwa/aviSrAMwa/asarAra/aharaha/AsaMga/Asafga/ikawAra
xinaxina	xina-prawixina/xina-xina/xina-para-xina/xina-baxina/xina-ba_xina/xinaprawixina/xinaxina/xinabaxina/xinoM-xina/xinoMxina
awyaXika	awyaMwa/awyanwa/awyaXika/be-iMwahA/beiMwahA/bahuwa_aXika/bahuwa_hI/bepanAha/saKZwa/saKwa/jamakara/mahA/nihAyawa/cUdZAMwa/cUdZAnwa/aByaXika/Agara
muAPika	anusAra/mAPika/muwAbika/anukUla/muAPZikZa/muAPika/muwAbikZa/aprawIRa
namrawApUrvaka	namrawApUrvaka/vinayapUrvaka
animeRa	takatakI_se/ekataka/tukura_tukura/taka-taka/animeRa/animiRa/animiKa/anamiKa/ikataka
xara-xara	xara-xara/xara-baxara/xvAra-xvAra
jisa_prakAra_se	jEsA/jEse/jisa_prakAra/jisa_prakAra_se
wadZa_se	Jatapata/catapata/PatAPata/wuraMwa/wuranwa/wawkAla/avilaMba/avilamba/PZOrana/POrana/KatAka_se/wawkRaNa/wadZAka_se/wadZa_se/wapAka_se/awiSIGra/awiSIGrawaH/jalxa_se_jalxa/jalxI_se_jalxI/wadZa_se/hAWoM-hAWa/hAWoM_hAWa/hAWo-hAWa/hAWo_hAWa/Kata_se/Anana-PAnana_meM/AnanaPAnana_meM/siwAba/siwAbI/besAKwA/TahAkA/ikahAI/ikahAU/Jatapata/catapata/PatAPata/wuraMwa/wuranwa/wawkAla/avilaMba/avilamba/PZOrana/POrana/KatAka_se/wawkRaNa/wadZAka_se/wadZa_se/wapAka_se/awiSIGra/awiSIGrawaH/jalxa_se_jalxa/jalxI_se_jalxI/wadZa_se/hAWoM-hAWa/hAWoM_hAWa/hAWo-hAWa/hAWo_hAWa/Kata_se/Anana-PAnana_meM/AnanaPAnana_meM/siwAba/siwAbI/besAKwA/TahAkA/ikahAI/ikahAU/wadZa_se/wadZAka_se
aMcakEM	acAnaka/ekAeka/sahasA/ekabAragI/ikabAragI/yakAyaka/akasmAwa/akasmAw/anAyAsa/xEvAw/xEvavaSa/Ocaka/aprawyASiwawaH/ApAwawaH/aMcakEM/agawyA/acaka/acAMcaka/acAkA/acAka/acAna/anAgawaH/anyAsa/nAgahAz/AcAna/ikahAI/ikahAU/iwwiPZAkZana/iwwiPAkana/iwwaPZAkZana/iwwaPAkana/ucakA/Ocaka
AramBawaH	AraMBa_meM/AraMBawaH/AramBawaH/pahale/SurU_meM/praWama/Axi_meM/praWamawaH/sarvapraWama/pUrva/SuruAwa_meM/SuruvAwa_meM/AramBa_meM/prAramBa_meM
Kuxa-ba-Kuxa	svawaH/apaneApa/KZuxa-ba-KZuxa/KZuxabaKZuxa/Kuxa-ba-Kuxa/KuxabaKuxa
jisa_prakAra	jEsA/jEse/jisa_prakAra/jisa_prakAra_se
samAnwara	samAMwara/samAnAMwara/samAnwara/samAnAnwara
isa_bIca	iwane_meM/isa_bIca/isI_bIca/isa_xOrAna/isa_xaramyAna
savirAmawaH	ruka-ruka_kara/ruka-rukakara/virAmawaH/Tahara_Tahara_kara/savirAmawaH
aviraWA	vyarWa/PZajUla/PijUla/PZijUla/anerA/yoM_hI/vqWA/apArWa/bAxa-havAI/bAxahavAI/ahewu/ahewuka/aviraWA
bagZEra	binA/bagZEra/bagEra
SiRtAcArapUrvaka	SiRtawaH/saByawaH/bAsaUra/SAlInawaH/SiRtAcArapUrvaka/salIkZe_se
maraNoparAnwa	maraNoparAMwa/maraNoparAnwa
sare_Ama	KuleAma/Kulakara/sareAma/sare-Ama/Kule-Ama/Kullama-KullA/KullamaKullA/daMke_kI_cota_para/sare_Ama/agupwawaH
iwanA	iwanA/iwA/iweka/iwe
anxAjZana	aMxAjana/aMxAjZana/anxAjZana/anxAjana/lagaBaga/wakZarIbana/wakarIbana/kZarIba/karIba/karIbakarIba/karIbana/kZarIbakZarIba/kZarIbana/anumAnawaH/anakZarIba/anakarIba/waKZamInana/aMxAja_se/ukavAz
yakAyaka	acAnaka/ekAeka/sahasA/ekabAragI/ikabAragI/yakAyaka/akasmAwa/akasmAw/anAyAsa/xEvAw/xEvavaSa/Ocaka/aprawyASiwawaH/ApAwawaH/aMcakEM/agawyA/acaka/acAMcaka/acAkA/acAka/acAna/anAgawaH/anyAsa/nAgahAz/AcAna/ikahAI/ikahAU/iwwiPZAkZana/iwwiPAkana/iwwaPZAkZana/iwwaPAkana/ucakA/Ocaka
gupacupa_rUpa_se	gupwawaH/gupacupa_rUpa_se/corI_Cipe
berahamI_se	nirxayawApUrvaka/nirxayawA_se/berahamI_se/bexarxI_se/krUrawApUrvaka/barbarawApUrvaka/kaTorawA_se/kadZAI_se
xina-prawixina	xina-prawixina/xina-xina/xina-para-xina/xina-baxina/xina-ba_xina/xinaprawixina/xinaxina/xinabaxina/xinoM-xina/xinoMxina
isI_kRaNa	aBI-aBI/aBI_aBI/aBI_hI/isI_vakwa/isI_kRaNa
niranwara	lagAwAra/anavarawa/niraMwara/niranwara/wAbadZawodZa/xanAxana/sawawa/XUAzXAra/anaMwara/ananwara/avirAmawaH/aniSa/prawikRaNa/anukRaNa/XadZAXadZa/avirawa/muwwasila/avicCinna/avicCexa/aviSrAnwa/aviSrAMwa/asarAra/aharaha/AsaMga/Asafga/ikawAra/hameSA/saxA/niwya/saxEva/niwya_prawi/sarvaxA/sarvaWA/haraxama/haravakwa/harasamaya/xina-rAwa/xinarAwa/xina_rAwa/rAwa-xina/rAwaxina/niSixina/nisa-vAsara/nisavAsara/niSivAsara/niranwara/niraMwara/anavaXi/sarvaxEva/aharaha/pinnA/aharniSa/ahorAwra
wiwara-biwara	wiwara-biwara/aswa-vyaswa/Cinna-Binna/bewarawIba/aswavyaswa/_avyavasWiwa
Agara	awyaMwa/awyanwa/awyaXika/be-iMwahA/beiMwahA/bahuwa_aXika/bahuwa_hI/bepanAha/saKZwa/saKwa/jamakara/mahA/nihAyawa/cUdZAMwa/cUdZAnwa/aByaXika/Agara
akasmAwa	acAnaka/ekAeka/sahasA/ekabAragI/ikabAragI/yakAyaka/akasmAwa/akasmAw/anAyAsa/xEvAw/xEvavaSa/Ocaka/aprawyASiwawaH/ApAwawaH/aMcakEM/agawyA/acaka/acAMcaka/acAkA/acAka/acAna/anAgawaH/anyAsa/nAgahAz/AcAna/ikahAI/ikahAU/iwwiPZAkZana/iwwiPAkana/iwwaPZAkZana/iwwaPAkana/ucakA/Ocaka
salIkZe_se	SiRtawaH/saByawaH/bAsaUra/SAlInawaH/SiRtAcArapUrvaka/salIkZe_se
pahale_se	pahale_se/pUrvawaH/pahale_se_hI
nAKuSI_se	aprasannawApUrvaka/nArAjZagIpUrvaka/nAKZuSI_se/nArAjagIpUrvaka/nAKuSI_se
prAramBa_meM	AraMBa_meM/AraMBawaH/AramBawaH/pahale/SurU_meM/praWama/Axi_meM/praWamawaH/sarvapraWama/pUrva/SuruAwa_meM/SuruvAwa_meM/AramBa_meM/prAramBa_meM
AnanaPAnana_meM	Jatapata/catapata/PatAPata/wuraMwa/wuranwa/wawkAla/avilaMba/avilamba/PZOrana/POrana/KatAka_se/wawkRaNa/wadZAka_se/wadZa_se/wapAka_se/awiSIGra/awiSIGrawaH/jalxa_se_jalxa/jalxI_se_jalxI/wadZa_se/hAWoM-hAWa/hAWoM_hAWa/hAWo-hAWa/hAWo_hAWa/Kata_se/Anana-PAnana_meM/AnanaPAnana_meM/siwAba/siwAbI/besAKwA/TahAkA/ikahAI/ikahAU
bArIkZI_se	bArIkZI_se/bArIkI_se/sUkRmawaH
isa_prakAra	yoM/yUz/Ese/isa_waraha/isa_prakAra/EsA/iwWaM/ima/imi/iBa/iva/isE/IxqS/IxqSa
eka_xUsare_se	paraspara/Apasa_meM/eka_xUsare_se/iwarewara
subaha-subaha	sabere/savere/subaha/wadZake/subaha-subaha/subaha_savere
niRkAraNa	akAraNa/bemawalaba/niRkAraNa/kAraNahInawaH/animiwwa
waxuparAnwa	wawapaScAwa/waxanaMwara/waxauparAMwa/waxoparAMwa/waxaMwara/waxananwara/waxuparAMwa/waxuparAnwa/waxoparAMwa/waxoparAnwa/waxanwara
Ese_hI	akAraNa/prayojanahInawaH/Ese_hI/yUz_hI/kAraNahInawaH/bevajaha/uxxeSyahInawaH/vyarWa_hI/yoM_hI/JUTa-mUTa/yOM_hI/yUz_hI/Ese_hI/nAhakZa/nAhaka/PZajZUla/PajUla/PZijZUla/PijUla/anahaka/anAhaka
KullamaKullA	KuleAma/Kulakara/sareAma/sare-Ama/Kule-Ama/Kullama-KullA/KullamaKullA/daMke_kI_cota_para/sare_Ama/agupwawaH
XIre_XIre	XIre-XIre/XIre_XIre/Ahiswe-Ahiswe/AhiswA-AhiswA/hOle-hOle/hole-hole/raPwA-raPwA/alpaSaH
kAraNahInawaH	akAraNa/bemawalaba/niRkAraNa/kAraNahInawaH/animiwwa/akAraNa/prayojanahInawaH/Ese_hI/yUz_hI/kAraNahInawaH/bevajaha/uxxeSyahInawaH
pICe-pICe	pICe-pICe/anupaxa/kaxama-ba_kaxama
rimaJima	rimaJima/rimaJima-rimaJima/rima-Jima
majZabUrana	majabUrana/vivaSawaH/anacAhe/majZabUrana/vivaSa_hokara/cAranAcAra/aMwawogawvA/barabasa
rAwa-xina	hameSA/saxA/niwya/saxEva/niwya_prawi/sarvaxA/sarvaWA/haraxama/haravakwa/harasamaya/xina-rAwa/xinarAwa/xina_rAwa/rAwa-xina/rAwaxina/niSixina/nisa-vAsara/nisavAsara/niSivAsara/niranwara/niraMwara/anavaXi/sarvaxEva/aharaha/pinnA/aharniSa/ahorAwra
Kata_se	Jatapata/catapata/PatAPata/wuraMwa/wuranwa/wawkAla/avilaMba/avilamba/PZOrana/POrana/KatAka_se/wawkRaNa/wadZAka_se/wadZa_se/wapAka_se/awiSIGra/awiSIGrawaH/jalxa_se_jalxa/jalxI_se_jalxI/wadZa_se/hAWoM-hAWa/hAWoM_hAWa/hAWo-hAWa/hAWo_hAWa/Kata_se/Anana-PAnana_meM/AnanaPAnana_meM/siwAba/siwAbI/besAKwA/TahAkA/ikahAI/ikahAU
bewahASA	aMXAXuMXa/bewahASA/anXAXunXa/aMXaXuMXa/anXaXunXa/utakkara
AraMBa_meM	AraMBa_meM/AraMBawaH/AramBawaH/pahale/SurU_meM/praWama/Axi_meM/praWamawaH/sarvapraWama/pUrva/SuruAwa_meM/SuruvAwa_meM/AramBa_meM/prAramBa_meM
xina-rAwa	hameSA/saxA/niwya/saxEva/niwya_prawi/sarvaxA/sarvaWA/haraxama/haravakwa/harasamaya/xina-rAwa/xinarAwa/xina_rAwa/rAwa-xina/rAwaxina/niSixina/nisa-vAsara/nisavAsara/niSivAsara/niranwara/niraMwara/anavaXi/sarvaxEva/aharaha/pinnA/aharniSa/ahorAwra
AmaraNa	mqwyuparyanwa/AjIvana/wAumra/umraBara/jZiMxagIBara/jiMxagIBara/jIvanaBara/AmaraNa/aMwima_xama_waka
sASru	sASru
CamaCama	CamaCama/Cama-Cama
kawwaI	kaxApi/haragijZa/kawaI/kawwaI
varIyawA_se	aXimAnawaH/varIyawA_se/acCA_ho_ki
AhiswA-AhiswA	XIre-XIre/XIre_XIre/Ahiswe-Ahiswe/AhiswA-AhiswA/hOle-hOle/hole-hole/raPwA-raPwA/alpaSaH
ananwara	bAxa/bAxa_meM/paScAw/uparAMwa/anaMwara/paScAwa/uparAnwa/ananwara/pICe/uwwara/aWa/anupaxa/anvakRa/lagAwAra/anavarawa/niraMwara/niranwara/wAbadZawodZa/xanAxana/sawawa/XUAzXAra/anaMwara/ananwara/avirAmawaH/aniSa/prawikRaNa/anukRaNa/XadZAXadZa/avirawa/muwwasila/avicCinna/avicCexa/aviSrAnwa/aviSrAMwa/asarAra/aharaha/AsaMga/Asafga/ikawAra
pUrI_waraha	pUrA/pUrI_waraha
howe_havAwe	aMwawaH/aMwawogawvA/aMwa_meM/AKira/AKZira/AKZirakAra/AKirakAra/howe_havAwe
kAma_se	prayojanawaH/kAma_se/kAraNa_se/saprayojana
paraspara	paraspara/Apasa_meM/eka_xUsare_se/iwarewara
kaBIkaBAra	kaBIkaBI/kaBIkaBAra/yaxAkaxA/kaBI-kaBI/kaBI-kaBAra/yaxA-kaxA/vakwan-POvakwan
bahuwa_bAra	kaI_bAra/bahuwa_bAra/anekaSaH
masalana	uxAharaNArWa/uxAharaNawaH/uxAharaNa_svarUpa/masalana
xina-baxina	xina-prawixina/xina-xina/xina-para-xina/xina-baxina/xina-ba_xina/xinaprawixina/xinaxina/xinabaxina/xinoM-xina/xinoMxina
asAvaXAnI_se	asAvaXAnawaH/asAvaXAnI_se/XyAnahInawaH/lAparavAhI_se
isa_xaramyAna	iwane_meM/isa_bIca/isI_bIca/isa_xOrAna/isa_xaramyAna
XIre	XIre/XIme/hOle/Ahiswe/AhiswA/Ahiswe_se/AhiswA_se/Asawe/Aswe
xarasAla	harasAla/prawivarRa/xarasAla/anuvawsara
AhiswA	XIre/XIme/hOle/Ahiswe/AhiswA/Ahiswe_se/AhiswA_se/Asawe/Aswe
jyAxA	Upara/aXika/jyAxA/jZyAxA/bahuwa/KZUba/KUba/badZA/jyAxA/jZyAxA/aXika/kAPZI/kAPI/kadZA/jamakara/datakara
aniSa	lagAwAra/anavarawa/niraMwara/niranwara/wAbadZawodZa/xanAxana/sawawa/XUAzXAra/anaMwara/ananwara/avirAmawaH/aniSa/prawikRaNa/anukRaNa/XadZAXadZa/avirawa/muwwasila/avicCinna/avicCexa/aviSrAnwa/aviSrAMwa/asarAra/aharaha/AsaMga/Asafga/ikawAra
kiswavAra	kZiswavAra/kiswavAra/kZiswa_xara_kZiswa/kZiswoM_meM
Ahiswe	XIre/XIme/hOle/Ahiswe/AhiswA/Ahiswe_se/AhiswA_se/Asawe/Aswe
awyaXika_prayawnapUrvaka	awyaXika_prayawnapUrvaka/mara-marakara
KZuxabaKZuxa	svawaH/apaneApa/KZuxa-ba-KZuxa/KZuxabaKZuxa/Kuxa-ba-Kuxa/KuxabaKuxa
nawIjawana	PalasvarUpa/pariNAma_svarUpa/pariNAmasvarUpa/pariNAmawaH/PalawaH/nawIjawana
narasoM	narasoM/awarasoM/warasoM/narasoM/awarasoM/warasoM
nipata	bilkula/bilakula/ekaxama/nipata/sarAsara/TIka/niwAMwa/niwAnwa/pUrNawaH/pUrI_waraha_se/pUrNawayA/saMpUrNawaH/saMpUrNawayA/pUrNarupeNa/AmUlacUla/Sawa-prawiSawa/akelA/akele/kevala/sirPZa/mAwra/KAlI/KZAlI/basa/nipata/mahajZa/sirPa/wanhA/wanahA/ekAkI/ekameva/ekaMga/ikelA
svecCayA	svecCApUrvaka/icCA_se/KZuSI_KZuSI/KZuSI_se/svecCayA/svecCawaH
anXaXunXa	aMXAXuMXa/bewahASA/anXAXunXa/aMXaXuMXa/anXaXunXa/utakkara
iwanA_hI	iwanA_hI/iwimAwra
kqwrima_rUpa_se	kqwrima_rUpa_se/kqwrimawA_se
xasa_gunA	xasagunA/xaSagunA/xasa_gunA/xaSa_gunA
animiRa	takatakI_se/ekataka/tukura_tukura/taka-taka/animeRa/animiRa/animiKa/anamiKa/ikataka
akAraNa	akAraNa/bemawalaba/niRkAraNa/kAraNahInawaH/animiwwa/akAraNa/prayojanahInawaH/Ese_hI/yUz_hI/kAraNahInawaH/bevajaha/uxxeSyahInawaH
edI	IsA_paScAw/I_pa/edI/IsA_paScAw
aBI_hI	aBI-aBI/aBI_aBI/aBI_hI/isI_vakwa/isI_kRaNa
eka_ora	eka_ora/eka_waraPa/eka_waraPZa/xarakinAra/xUra/alaga/eka_waraPZa/eka_ora/alahaxA
avvalana	pahale_pahala/praWamawaH/sarva_praWama/sarvapraWama/SurU_meM/pahale-pahala/avvalana/pahile_pahala/pahile_pahala
yahAz_para	iXara/isa_ora/yahAz_para/iwaH/iwa/iwE/iwWe
kuviXipUrvaka	viXihInawaH/kuviXipUrvaka/bewarIkZe
xUnA	xugunA/xUnA/xogunA/xuganA/xviguNa/xviguNiwa
AwaMkapUrvaka	AwaMkapUrvaka/sAwaMka
beSaka	niHsaMxeha/nissaMxeha/jarUra/jZarUra/niHsanxeha/nissanxeha/nisaMxeha/nisanxeha/binA_Saka/beSaka/bilkula/bilakula/yakInana/yakZInana/avaSyameva/avaSya/alabawwA/bilASaka/aBarama/vASinxA/bASinxA/avasi/aviwarkika/asaMSaya/niSciwawaH/ikaMka
jAnabUJakara	jAna-bUJakara/jAnabUJakara/jAnabUJa_kara/amaxana/icCApUrvaka/mawipUrva/irAxawana
sAXAraNawaH	sAmAnyawaH/sAmAnyawayA/sAXAraNawaH/sAXAraNawayA/amUmana/umUmana
balapUrvaka	balapUrvaka/barabasa/jZabaraxaswI/jabaraxaswI/jZabarana/jabarana/barajZorI
warawIbavAra	kramaSaH/kramAnusAra/yaWAkrama/silasilevAra/bArI-bArI_se/kramavAra/warawIbavAra/ayugapaxa/alpaSaH
BarapUra	BalI-BAzwi/BalI_BAzwi/BarapUra/BalIBAzwi/BalI-BAMwi/BalI_BAMwi/BalIBAMwi/sarvawoBAva/acCI_waraha
xaraparaxA	cupake_se/cupake-cupake/xaraparaxA
jalxa_se_jalxa	Jatapata/catapata/PatAPata/wuraMwa/wuranwa/wawkAla/avilaMba/avilamba/PZOrana/POrana/KatAka_se/wawkRaNa/wadZAka_se/wadZa_se/wapAka_se/awiSIGra/awiSIGrawaH/jalxa_se_jalxa/jalxI_se_jalxI/wadZa_se/hAWoM-hAWa/hAWoM_hAWa/hAWo-hAWa/hAWo_hAWa/Kata_se/Anana-PAnana_meM/AnanaPAnana_meM/siwAba/siwAbI/besAKwA/TahAkA/ikahAI/ikahAU
Pira_se	xubArA/xobArA/Pira/Pira_se/punaH/eka_bAra_Pira/vApasa_se
vilaMbapUrvaka	vilaMbawaH/aSIGrawaH/xerI_se/vilaMbapUrvaka/xera_meM
AxeSapUrvaka	AjFApUrvaka/AxeSapUrvaka/sAxeSa/AxeSa_se
xara-baxara	xara-xara/xara-baxara/xvAra-xvAra
binamAzge	binamAzge/bina_mAzge/anamAzge/ayAciwawaH
weja	kasakara/joraxAra/weja/wejZa/wIvra/wejZI_se/jZora_se/wejI_se/jora_se/wIvrawA_se
kahe_anusAra	kaWanAnusAra/kahanAnusAra/kahe_muwAbika/kahe_muwAbikZa/kahe_anusAra
kqpApUrvaka	xayApUrvaka/kqpA_kara_ke/kqpApUrvaka/xayA_se/barAe_meharabAnI/kqpayA/kqpApUrvaka/kqpA_pUrvaka/kqpA_karake/meharabAnI_karake
pUrva	AraMBa_meM/AraMBawaH/AramBawaH/pahale/SurU_meM/praWama/Axi_meM/praWamawaH/sarvapraWama/pUrva/SuruAwa_meM/SuruvAwa_meM/AramBa_meM/prAramBa_meM
kZarIne_se	warIkZe_se/warIke_se/warawIba_se/kZarIne_se/karIne_se/vyavasWApUrvaka/vyavasWiwawaH/kZarInAvAra/karInAvAra
sAWa-sAWa	sAWa-sAWa/sAWa_hI/sAWa_hI_sAWa/sAWa/eka_sAWa/ikatTA/ikajora/ekawra/ikawra
kAraNawaH	kAraNavaSa/kAraNawaH
isa_sAla	aso/asoM/AsO/isa_varRa/isa_sAla
bagamela	bagamela/baga-mela
sahiwa	sahiwa/samewa
WodZA-WodZA	alpawaH/WodZA-WodZA/WodZA_WodZA/alpaSaH
waxanwara	wawapaScAwa/waxanaMwara/waxauparAMwa/waxoparAMwa/waxaMwara/waxananwara/waxuparAMwa/waxuparAnwa/waxoparAMwa/waxoparAnwa/waxanwara
aXikArahInawaH	anaXikAra/aXikArahInawaH
agupwawaH	KuleAma/Kulakara/sareAma/sare-Ama/Kule-Ama/Kullama-KullA/KullamaKullA/daMke_kI_cota_para/sare_Ama/agupwawaH
wibArA	wibArA/webArA
alaga	xUra/xUrI_para/alaga/pare/xarakinAra/xUra/alaga/eka_waraPZa/eka_ora/alahaxA
ayugapaxa	kramaSaH/kramAnusAra/yaWAkrama/silasilevAra/bArI-bArI_se/kramavAra/warawIbavAra/ayugapaxa/alpaSaH
agawyA	acAnaka/ekAeka/sahasA/ekabAragI/ikabAragI/yakAyaka/akasmAwa/akasmAw/anAyAsa/xEvAw/xEvavaSa/Ocaka/aprawyASiwawaH/ApAwawaH/aMcakEM/agawyA/acaka/acAMcaka/acAkA/acAka/acAna/anAgawaH/anyAsa/nAgahAz/AcAna/ikahAI/ikahAU/iwwiPZAkZana/iwwiPAkana/iwwaPZAkZana/iwwaPAkana/ucakA/Ocaka/BaviRya_meM/Age/BaviRya_kAla_meM/agawyA
xubArA	xubArA/xobArA/Pira/Pira_se/punaH/eka_bAra_Pira/vApasa_se
aswavyaswa	wiwara-biwara/aswa-vyaswa/Cinna-Binna/bewarawIba/aswavyaswa/_avyavasWiwa
samaJa-bUJakara	soca-vicArakara/samaJa-bUJakara/vicArapUrvaka/soca-samaJakara/soca_vicAra_kara/samaJa_bUJa_kara/soca_samaJa_kara/vicAriwawaH
pUrNawaH	bilkula/bilakula/ekaxama/nipata/sarAsara/TIka/niwAMwa/niwAnwa/pUrNawaH/pUrI_waraha_se/pUrNawayA/saMpUrNawaH/saMpUrNawayA/pUrNarupeNa/AmUlacUla/Sawa-prawiSawa
bIcama_bIca	bIcobIca/bIcoMbIca/bIcoM-bIca/bIcama_bIca/bIcoM_bIca
cOgunA	cOgunA/cAra_gunA/cAragunA/cawurguNa
sAPa-sAPa	spaRta/spaRtawaH/Kula_kara/Kule_wOra_para/Kullama_KullA/binA_lAga_lapeta_ke/sAPZa_sAPZa/spaRtawayA/sAPZa-sAPZa/sAPa-sAPa
anyaxA	anyexyu/anyaxA
aviwarkika	niHsaMxeha/nissaMxeha/jarUra/jZarUra/niHsanxeha/nissanxeha/nisaMxeha/nisanxeha/binA_Saka/beSaka/bilkula/bilakula/yakInana/yakZInana/avaSyameva/avaSya/alabawwA/bilASaka/aBarama/vASinxA/bASinxA/avasi/aviwarkika/asaMSaya/niSciwawaH/ikaMka
CinaCina	prawikRaNa/pala_pala/pala-pala/prawipala/hara_kRaNa/kRaNa-kRaNa/haraGadZI/hara_GadZI/prawi_kRaNa/kRaNakRaNa/anukRaNa/CinaCina/Cina-Cina/AKana
ke_anxara	ke_aMxara/ke_anxara/ke_BIwara/meM
avalaMbiwa	jalxI/SIGra/SIGrawaH/avilaMbawaH/jalxa/acira/wUrNa/SiwAba/begi/avalaMbiwa/avalambiwa/jalxI_se/ASu/avilaMbiwa/avilambiwa
kqwrimawA_se	kqwrima_rUpa_se/kqwrimawA_se
BinasAre	BinasAre/Binasahare
ayAsa	anAyAsa/binA_pariSrama/aprayawnawaH/prayawnahInawaH/ayAsa
SIGra	jalxI/SIGra/SIGrawaH/avilaMbawaH/jalxa/acira/wUrNa/SiwAba/begi/avalaMbiwa/avalambiwa/jalxI_se/ASu/avilaMbiwa/avilambiwa
ihavAz	yahAz/isa_jagaha/iwaH/iwa/iha/ihAz/ihavAz/IMGe/IhAz
JUTa-mUTa	vyarWa_hI/yoM_hI/JUTa-mUTa/yOM_hI/yUz_hI/Ese_hI/nAhakZa/nAhaka/PZajZUla/PajUla/PZijZUla/PijUla/anahaka/anAhaka
CahagunA	CahagunA/COgunA/CaHgunA
nissaMkoca	nisaMkoca/niHsaMkoca/nissaMkoca/beXadZaka/saMkocahInawaH/beJiJaka/beKataka/beKatake/behicaka
hara_jagaha	cAroM_ora/cAroM_waraPZa/cAroM_waraPa/cahuz_ora/sarvawra/saBI_waraPZa/cAroM_xiSAoM_meM/hara_jagaha/irxa-girxa
aXoraXa	Upara-nIce/aXoraXa/aXorXa/aXOrxXa
aBE	aBI/PZilahAla/PilahAla/isa_samaya/aba/aWa/aXunA/saMprawi/samprawi/aBU/aBE
aBI	aBI/PZilahAla/PilahAla/isa_samaya/aba/aWa/aXunA/saMprawi/samprawi/aBU/aBE
aBU	aBI/PZilahAla/PilahAla/isa_samaya/aba/aWa/aXunA/saMprawi/samprawi/aBU/aBE
IsA_pUrva	IsApUrva/IsA_pUrva/IsavI_pUrva
pariNAmawaH	PalasvarUpa/pariNAma_svarUpa/pariNAmasvarUpa/pariNAmawaH/PalawaH/nawIjawana
yoM_hI	vyarWa_hI/yoM_hI/JUTa-mUTa/yOM_hI/yUz_hI/Ese_hI/nAhakZa/nAhaka/PZajZUla/PajUla/PZijZUla/PijUla/anahaka/anAhaka/vyarWa/PZajUla/PijUla/PZijUla/anerA/yoM_hI/vqWA/apArWa/bAxa-havAI/bAxahavAI/ahewu/ahewuka/aviraWA
isI_vakwa	aBI-aBI/aBI_aBI/aBI_hI/isI_vakwa/isI_kRaNa
sAPZa_sAPZa	spaRta/spaRtawaH/Kula_kara/Kule_wOra_para/Kullama_KullA/binA_lAga_lapeta_ke/sAPZa_sAPZa/spaRtawayA/sAPZa-sAPZa/sAPa-sAPa
AyaMxA	aba/Age/AinxA/AiMxA/AyaMxA/AyanxA
TuzsATuzsa	TasATasa/TuzsATuzsa/KacAKaca/TusATusa
muswExI_se	sPUrwipUrvaka/cuswI_se/PurwI_se/muswExI_se
niScayapUrvaka	saMkalpapUrvaka/irAxawana/irAxe_se/xqDZawApUrvaka/niScayapUrvaka
Agraha_se	AgrahapUrvaka/Agraha_se
XyAna_se	sAvaXAnIpUrvaka/XyAnapUrvaka/XyAna_se/sAvaXAnI_se/sAvaXAnawaH/samBAlakara/saMBAlakara
iwWaMmeva	isI_waraha/isI_prakAra/iwWaMmeva
saBI_waraPZa	cAroM_ora/cAroM_waraPZa/cAroM_waraPa/cahuz_ora/sarvawra/saBI_waraPZa/cAroM_xiSAoM_meM/hara_jagaha/irxa-girxa
eka_sAWa	sAWa-sAWa/sAWa_hI/sAWa_hI_sAWa/sAWa/eka_sAWa/ikatTA/ikajora/ekawra/ikawra
kZarIbakZarIba	aMxAjana/aMxAjZana/anxAjZana/anxAjana/lagaBaga/wakZarIbana/wakarIbana/kZarIba/karIba/karIbakarIba/karIbana/kZarIbakZarIba/kZarIbana/anumAnawaH/anakZarIba/anakarIba/waKZamInana/aMxAja_se/ukavAz
sAxara	sawkArapUrvaka/sAxara/sasammAna/Axara_sahiwa
anamAzge	binamAzge/bina_mAzge/anamAzge/ayAciwawaH
binA	binA/bagZEra/bagEra
kahanAnusAra	kaWanAnusAra/kahanAnusAra/kahe_muwAbika/kahe_muwAbikZa/kahe_anusAra
samprawi	aBI/PZilahAla/PilahAla/isa_samaya/aba/aWa/aXunA/saMprawi/samprawi/aBU/aBE
Axi_meM	AraMBa_meM/AraMBawaH/AramBawaH/pahale/SurU_meM/praWama/Axi_meM/praWamawaH/sarvapraWama/pUrva/SuruAwa_meM/SuruvAwa_meM/AramBa_meM/prAramBa_meM
jAna-bUJakara	jAna-bUJakara/jAnabUJakara/jAnabUJa_kara/amaxana/icCApUrvaka/mawipUrva/irAxawana
Jatapata	Jatapata/catapata/PatAPata/wuraMwa/wuranwa/wawkAla/avilaMba/avilamba/PZOrana/POrana/KatAka_se/wawkRaNa/wadZAka_se/wadZa_se/wapAka_se/awiSIGra/awiSIGrawaH/jalxa_se_jalxa/jalxI_se_jalxI/wadZa_se/hAWoM-hAWa/hAWoM_hAWa/hAWo-hAWa/hAWo_hAWa/Kata_se/Anana-PAnana_meM/AnanaPAnana_meM/siwAba/siwAbI/besAKwA/TahAkA/ikahAI/ikahAU
kiMkarwwavya-vimUDZa	hakkA-bakkA/BOMcakkA/kiMkarwavya-vimUDZa/kiMkarwwavya-vimUDZa/kiMkarwavyavimUDZa/kiMkarwwavyavimUDZa/hawabuxXi
eka_bAra_Pira	xubArA/xobArA/Pira/Pira_se/punaH/eka_bAra_Pira/vApasa_se
anasUyawaH	IrRyAhInawaH/anasUyawaH/xveRahInawaH
avicCinna	lagAwAra/anavarawa/niraMwara/niranwara/wAbadZawodZa/xanAxana/sawawa/XUAzXAra/anaMwara/ananwara/avirAmawaH/aniSa/prawikRaNa/anukRaNa/XadZAXadZa/avirawa/muwwasila/avicCinna/avicCexa/aviSrAnwa/aviSrAMwa/asarAra/aharaha/AsaMga/Asafga/ikawAra
pala-pala	prawikRaNa/pala_pala/pala-pala/prawipala/hara_kRaNa/kRaNa-kRaNa/haraGadZI/hara_GadZI/prawi_kRaNa/kRaNakRaNa/anukRaNa/CinaCina/Cina-Cina/AKana
roja	prawixina/haraxina/niwya/hararojZa/rojZa/niwa/roja/rojZAnA/rojAnA/anuxina/niwyaprawi/anuxivasa/aharaha
xinarAwa	hameSA/saxA/niwya/saxEva/niwya_prawi/sarvaxA/sarvaWA/haraxama/haravakwa/harasamaya/xina-rAwa/xinarAwa/xina_rAwa/rAwa-xina/rAwaxina/niSixina/nisa-vAsara/nisavAsara/niSivAsara/niranwara/niraMwara/anavaXi/sarvaxEva/aharaha/pinnA/aharniSa/ahorAwra
Gara-Gara	Gara-Gara/Gara_Gara
anacAhe	majabUrana/vivaSawaH/anacAhe/majZabUrana/vivaSa_hokara/cAranAcAra/aMwawogawvA/barabasa
wuraMwa	Jatapata/catapata/PatAPata/wuraMwa/wuranwa/wawkAla/avilaMba/avilamba/PZOrana/POrana/KatAka_se/wawkRaNa/wadZAka_se/wadZa_se/wapAka_se/awiSIGra/awiSIGrawaH/jalxa_se_jalxa/jalxI_se_jalxI/wadZa_se/hAWoM-hAWa/hAWoM_hAWa/hAWo-hAWa/hAWo_hAWa/Kata_se/Anana-PAnana_meM/AnanaPAnana_meM/siwAba/siwAbI/besAKwA/TahAkA/ikahAI/ikahAU
baDZA-caDZAkara	baDZA-caDZAkara/baDZAcaDZAkara
niyama_se	niyamiwawaH/niyama_se/niyamAnusAra/baxaswUra
PZijUla	vyarWa/PZajUla/PijUla/PZijUla/anerA/yoM_hI/vqWA/apArWa/bAxa-havAI/bAxahavAI/ahewu/ahewuka/aviraWA
IsApUrva	IsApUrva/IsA_pUrva/IsavI_pUrva
PUtaPUta_kara	PUta-PUtakara/PUtaPUta_kara
SurU_meM	pahale_pahala/praWamawaH/sarva_praWama/sarvapraWama/SurU_meM/pahale-pahala/avvalana/pahile_pahala/pahile_pahala/AraMBa_meM/AraMBawaH/AramBawaH/pahale/SurU_meM/praWama/Axi_meM/praWamawaH/sarvapraWama/pUrva/SuruAwa_meM/SuruvAwa_meM/AramBa_meM/prAramBa_meM
yaWASakwi	yaWASakwi/Barasaka/yaWAsAXya/yaWAsaMBava/kRamawAnusAra/yaWAkRama
hawabuxXi	hakkA-bakkA/BOMcakkA/kiMkarwavya-vimUDZa/kiMkarwwavya-vimUDZa/kiMkarwavyavimUDZa/kiMkarwwavyavimUDZa/hawabuxXi
WodZA_sA	jarA/jZarA/jarA-sA/jZarA-sA/rawwiBara/WodZA/WodZA-sA/WodZA_sA/wanika/yawkiMciw/nAmamAwra/leSamAwra/raMcamAwra/WodZA_sA
wejZa	kasakara/joraxAra/weja/wejZa/wIvra/wejZI_se/jZora_se/wejI_se/jora_se/wIvrawA_se
sawagunA	sAwagunA/sawagunA
aXyakRara	akRaraSaH/SabxaSaH/aXyakRara
wanhA	akelA/akele/kevala/sirPZa/mAwra/KAlI/KZAlI/basa/nipata/mahajZa/sirPa/wanhA/wanahA/ekAkI/ekameva/ekaMga/ikelA
nisanxeha	niHsaMxeha/nissaMxeha/jarUra/jZarUra/niHsanxeha/nissanxeha/nisaMxeha/nisanxeha/binA_Saka/beSaka/bilkula/bilakula/yakInana/yakZInana/avaSyameva/avaSya/alabawwA/bilASaka/aBarama/vASinxA/bASinxA/avasi/aviwarkika/asaMSaya/niSciwawaH/ikaMka
isalie	isalie/isIlie/awaeva/awaH/lihAjA/lihAjZA
ultA-paltA	ulatA-pulatA/ulatA_pulatA/ulatA-palatA/ultA-paltA/ultA-pultA/ultA_pultA
sAmane	sAmane/Age/samakRa/sammuKa/agre/anvakRa/aBimuKa/xarapeSa/Agala/AgalA/sIXe/sIXA/sAmane/sAmane
anupaxa	pICe-pICe/anupaxa/kaxama-ba_kaxama/bAxa/bAxa_meM/paScAw/uparAMwa/anaMwara/paScAwa/uparAnwa/ananwara/pICe/uwwara/aWa/anupaxa/anvakRa
niHsvArWa	nisvArWa/niHsvArWa
joroM_se	jZora-Sora_se/jora-Sora_se/jZoraSora_se/joraSora_se/jZoroM_se/joroM_se
jamakara	bahuwa/KZUba/KUba/badZA/jyAxA/jZyAxA/aXika/kAPZI/kAPI/kadZA/jamakara/datakara/awyaMwa/awyanwa/awyaXika/be-iMwahA/beiMwahA/bahuwa_aXika/bahuwa_hI/bepanAha/saKZwa/saKwa/jamakara/mahA/nihAyawa/cUdZAMwa/cUdZAnwa/aByaXika/Agara
banisbawa	apekRAkqwa/wulanA_meM/apekRayA/mukZAbale/mukAbale/banisbawa/se
viswArapUrvaka	viswArapUrvaka/viswAra_se
SAMwipUrvaka	SAMwipUrvaka/SAnwipUrvaka
jZoraSora_se	jZora-Sora_se/jora-Sora_se/jZoraSora_se/joraSora_se/jZoroM_se/joroM_se
KZuSI_se	svecCApUrvaka/icCA_se/KZuSI_KZuSI/KZuSI_se/svecCayA/svecCawaH/prasannawApUrvaka/KZuSI_KZuSI/KuSI_KuSI/KZuSI_se/KuSI_se/prasannawaH/saharRa/harRapUrvaka
sabere	sabere/savere/subaha/wadZake/subaha-subaha/subaha_savere/jalxI/savere/sabere
nimeRa-mAwra	palaBara/pala-Bara/nimiRa-mAwra/nimeRa-mAwra
tanAtana	acCA/baDZiyA/acCI_waraha/acCI_waraha_se/tanAtana
wInagunA	wigunA/wInagunA/wIna_gunA
vAkaI	vAkaI/vAkZaI/vAswava_meM/hakIkawana/hakZIkZawana/xaraasala/asala_meM/sacamuca/saccI-muccI/saccI_muccI/sawyawaH/vaswuwaH
niSivAsara	hameSA/saxA/niwya/saxEva/niwya_prawi/sarvaxA/sarvaWA/haraxama/haravakwa/harasamaya/xina-rAwa/xinarAwa/xina_rAwa/rAwa-xina/rAwaxina/niSixina/nisa-vAsara/nisavAsara/niSivAsara/niranwara/niraMwara/anavaXi/sarvaxEva/aharaha/pinnA/aharniSa/ahorAwra
ASu	jalxI/SIGra/SIGrawaH/avilaMbawaH/jalxa/acira/wUrNa/SiwAba/begi/avalaMbiwa/avalambiwa/jalxI_se/ASu/avilaMbiwa/avilambiwa
sarva_praWama	pahale_pahala/praWamawaH/sarva_praWama/sarvapraWama/SurU_meM/pahale-pahala/avvalana/pahile_pahala/pahile_pahala
aXikawara	prAyaH/akasara/aksara/aXikawara/aXikAMSawaH/jyAxAwara/bahuXA/AmawOra_para/AmawOra_se/aXikAMSawayA/prAyaSaH/anekaXA
hakkA-bakkA	hakkA-bakkA/BOMcakkA/kiMkarwavya-vimUDZa/kiMkarwwavya-vimUDZa/kiMkarwavyavimUDZa/kiMkarwwavyavimUDZa/hawabuxXi
acCI_waraha	BalI-BAzwi/BalI_BAzwi/BarapUra/BalIBAzwi/BalI-BAMwi/BalI_BAMwi/BalIBAMwi/sarvawoBAva/acCI_waraha/acCI_waraha/acCI_waraha_se/acCI_waraha/acCI_waraha_se/acCA/baDZiyA/acCI_waraha/acCI_waraha_se/tanAtana/TIka/TIka_se/acCI_waraha/acCI_waraha_se/acCI_waraha/acCI_waraha_se
anerA	vyarWa/PZajUla/PijUla/PZijUla/anerA/yoM_hI/vqWA/apArWa/bAxa-havAI/bAxahavAI/ahewu/ahewuka/aviraWA
warIkZe_se	yukwipUrvaka/upAyawaH/upAya_se/jugawa_lagAkara/warakIba_se/warIkZe_se/warIkZe_se/warIke_se/warawIba_se/kZarIne_se/karIne_se/vyavasWApUrvaka/vyavasWiwawaH/kZarInAvAra/karInAvAra/viXipUrvaka/kZAyaxe_se/DaMga_se/warIkZe_se/bawOra/bAkZAyaxA/viXivaw/viXivawa
iha	yahAz/isa_jagaha/iwaH/iwa/iha/ihAz/ihavAz/IMGe/IhAz
Upara-nIce	Upara-nIce/aXoraXa/aXorXa/aXOrxXa
haswacAlana_xvArA	hAWa_se/hAWa_xvArA/haswacAliwa_DaMga_se/haswacAlana_xvArA
sawawa	lagAwAra/anavarawa/niraMwara/niranwara/wAbadZawodZa/xanAxana/sawawa/XUAzXAra/anaMwara/ananwara/avirAmawaH/aniSa/prawikRaNa/anukRaNa/XadZAXadZa/avirawa/muwwasila/avicCinna/avicCexa/aviSrAnwa/aviSrAMwa/asarAra/aharaha/AsaMga/Asafga/ikawAra
PalawaH	PalasvarUpa/pariNAma_svarUpa/pariNAmasvarUpa/pariNAmawaH/PalawaH/nawIjawana
jEse_wEse	kaTinAI_se/jEse_wEse/muSkila_se/bamuSkila/kaTinawaH/nITi
akasara	prAyaH/akasara/aksara/aXikawara/aXikAMSawaH/jyAxAwara/bahuXA/AmawOra_para/AmawOra_se/aXikAMSawayA/prAyaSaH/anekaXA
sahajawaH	AsAnI_se/sahajawA_se/saralawA_se/Kela_Kela_meM/sahajawaH/anEse
xinabaxina	xina-prawixina/xina-xina/xina-para-xina/xina-baxina/xina-ba_xina/xinaprawixina/xinaxina/xinabaxina/xinoM-xina/xinoMxina
viswAra_se	viswArapUrvaka/viswAra_se
anyexyu	anyexyu/anyaxA
icCAnusAra	icCAnusAra/icCAnukula/yaWecCa/yaWABIRta/yaWAvAMCiwa
mAPika	anusAra/mAPika/muwAbika/anukUla/muAPZikZa/muAPika/muwAbikZa/aprawIRa
nirbAXa	nirbAXa/bAXArahiwa/akaMtaka
hAjZira	peSa/hAjZira/hAjira
pala_pala	prawikRaNa/pala_pala/pala-pala/prawipala/hara_kRaNa/kRaNa-kRaNa/haraGadZI/hara_GadZI/prawi_kRaNa/kRaNakRaNa/anukRaNa/CinaCina/Cina-Cina/AKana
kZAnUnana	kZAnUnana/kAnUnana/viXAnawaH
cAroM_waraPa	cAroM_ora/cAroM_waraPZa/cAroM_waraPa/cahuz_ora/sarvawra/saBI_waraPZa/cAroM_xiSAoM_meM/hara_jagaha/irxa-girxa
aprasannawApUrvaka	aprasannawApUrvaka/nArAjZagIpUrvaka/nAKZuSI_se/nArAjagIpUrvaka/nAKuSI_se
bIcoM-bIca	bIcobIca/bIcoMbIca/bIcoM-bIca/bIcama_bIca/bIcoM_bIca
anamiKa	takatakI_se/ekataka/tukura_tukura/taka-taka/animeRa/animiRa/animiKa/anamiKa/ikataka
nirxayawApUrvaka	nirxayawApUrvaka/nirxayawA_se/berahamI_se/bexarxI_se/krUrawApUrvaka/barbarawApUrvaka/kaTorawA_se/kadZAI_se
maxxenajara	maxxenajZara/maxxenajara
akRaraSaH	akRaraSaH/SabxaSaH/aXyakRara
kiMkarwavyavimUDZa	hakkA-bakkA/BOMcakkA/kiMkarwavya-vimUDZa/kiMkarwwavya-vimUDZa/kiMkarwavyavimUDZa/kiMkarwwavyavimUDZa/hawabuxXi
xEvavaSa	acAnaka/ekAeka/sahasA/ekabAragI/ikabAragI/yakAyaka/akasmAwa/akasmAw/anAyAsa/xEvAw/xEvavaSa/Ocaka/aprawyASiwawaH/ApAwawaH/aMcakEM/agawyA/acaka/acAMcaka/acAkA/acAka/acAna/anAgawaH/anyAsa/nAgahAz/AcAna/ikahAI/ikahAU/iwwiPZAkZana/iwwiPAkana/iwwaPZAkZana/iwwaPAkana/ucakA/Ocaka
vargAkAra_meM	cOkora_meM/vargAkAra_meM
SuruAwa_meM	AraMBa_meM/AraMBawaH/AramBawaH/pahale/SurU_meM/praWama/Axi_meM/praWamawaH/sarvapraWama/pUrva/SuruAwa_meM/SuruvAwa_meM/AramBa_meM/prAramBa_meM
muwAbikZa	anusAra/mAPika/muwAbika/anukUla/muAPZikZa/muAPika/muwAbikZa/aprawIRa
Axawana	svaBAvawaH/Axawana
cOkora_meM	cOkora_meM/vargAkAra_meM
palaBara	palaBara/pala-Bara/nimiRa-mAwra/nimeRa-mAwra
savismaya	AScaryapUrvaka/savismaya/sAScarya
TIka_se	sakuSala/kuSalawApUrvaka/kuSalapUrvaka/sahI_salAmawa/sahI-salAmawa/TIka-TAka/TIka_se/TIka-TAka_se/TIkaTAka/baKZEra/baKEra/baKZErIya/baKErIyawa/surakRiwawaH/TIka/TIka_se/acCI_waraha/acCI_waraha_se
Pira	xubArA/xobArA/Pira/Pira_se/punaH/eka_bAra_Pira/vApasa_se
Kullama-KullA	KuleAma/Kulakara/sareAma/sare-Ama/Kule-Ama/Kullama-KullA/KullamaKullA/daMke_kI_cota_para/sare_Ama/agupwawaH
kaBI_BI	kaBI_BI
anyawaH	anyawaH/anyawaH
Age-pICe	AgepICe/Age_pICe/Age-pICe/pUrvApara
petaBara	Barapeta/petaBara
AgrahapUrvaka	AgrahapUrvaka/Agraha_se
isI_bIca	iwane_meM/isa_bIca/isI_bIca/isa_xOrAna/isa_xaramyAna
icCApUrvaka	jAna-bUJakara/jAnabUJakara/jAnabUJa_kara/amaxana/icCApUrvaka/mawipUrva/irAxawana
SIGrawaH	jalxI/SIGra/SIGrawaH/avilaMbawaH/jalxa/acira/wUrNa/SiwAba/begi/avalaMbiwa/avalambiwa/jalxI_se/ASu/avilaMbiwa/avilambiwa
pACe	pICe/paScawaH/pACe/pqRTawaH/arvAka
harRapUrvaka	prasannawApUrvaka/KZuSI_KZuSI/KuSI_KuSI/KZuSI_se/KuSI_se/prasannawaH/saharRa/harRapUrvaka
prAyaH	aXikawaH/aXikAMSawaH/prAyaH/aXikAMSawayA/prAyaH/akasara/aksara/aXikawara/aXikAMSawaH/jyAxAwara/bahuXA/AmawOra_para/AmawOra_se/aXikAMSawayA/prAyaSaH/anekaXA
ikataka	takatakI_se/ekataka/tukura_tukura/taka-taka/animeRa/animiRa/animiKa/anamiKa/ikataka
amaxana	jAna-bUJakara/jAnabUJakara/jAnabUJa_kara/amaxana/icCApUrvaka/mawipUrva/irAxawana
Asawe	XIre/XIme/hOle/Ahiswe/AhiswA/Ahiswe_se/AhiswA_se/Asawe/Aswe
wapAka_se	Jatapata/catapata/PatAPata/wuraMwa/wuranwa/wawkAla/avilaMba/avilamba/PZOrana/POrana/KatAka_se/wawkRaNa/wadZAka_se/wadZa_se/wapAka_se/awiSIGra/awiSIGrawaH/jalxa_se_jalxa/jalxI_se_jalxI/wadZa_se/hAWoM-hAWa/hAWoM_hAWa/hAWo-hAWa/hAWo_hAWa/Kata_se/Anana-PAnana_meM/AnanaPAnana_meM/siwAba/siwAbI/besAKwA/TahAkA/ikahAI/ikahAU
vAkZaI	vAkaI/vAkZaI/vAswava_meM/hakIkawana/hakZIkZawana/xaraasala/asala_meM/sacamuca/saccI-muccI/saccI_muccI/sawyawaH/vaswuwaH
meharabAnI_karake	kqpayA/kqpApUrvaka/kqpA_pUrvaka/kqpA_karake/meharabAnI_karake
anEse	AsAnI_se/sahajawA_se/saralawA_se/Kela_Kela_meM/sahajawaH/anEse/anEse
hOle-hOle	XIre-XIre/XIre_XIre/Ahiswe-Ahiswe/AhiswA-AhiswA/hOle-hOle/hole-hole/raPwA-raPwA/alpaSaH
sarvaWA	hameSA/saxA/niwya/saxEva/niwya_prawi/sarvaxA/sarvaWA/haraxama/haravakwa/harasamaya/xina-rAwa/xinarAwa/xina_rAwa/rAwa-xina/rAwaxina/niSixina/nisa-vAsara/nisavAsara/niSivAsara/niranwara/niraMwara/anavaXi/sarvaxEva/aharaha/pinnA/aharniSa/ahorAwra
yaWAvawa	yaWAvaw/yaWAvawa
bahuwa_aXika	awyaMwa/awyanwa/awyaXika/be-iMwahA/beiMwahA/bahuwa_aXika/bahuwa_hI/bepanAha/saKZwa/saKwa/jamakara/mahA/nihAyawa/cUdZAMwa/cUdZAnwa/aByaXika/Agara
bilASaka	niHsaMxeha/nissaMxeha/jarUra/jZarUra/niHsanxeha/nissanxeha/nisaMxeha/nisanxeha/binA_Saka/beSaka/bilkula/bilakula/yakInana/yakZInana/avaSyameva/avaSya/alabawwA/bilASaka/aBarama/vASinxA/bASinxA/avasi/aviwarkika/asaMSaya/niSciwawaH/ikaMka
sarvaxEva	hameSA/saxA/niwya/saxEva/niwya_prawi/sarvaxA/sarvaWA/haraxama/haravakwa/harasamaya/xina-rAwa/xinarAwa/xina_rAwa/rAwa-xina/rAwaxina/niSixina/nisa-vAsara/nisavAsara/niSivAsara/niranwara/niraMwara/anavaXi/sarvaxEva/aharaha/pinnA/aharniSa/ahorAwra
aswa-vyaswa	wiwara-biwara/aswa-vyaswa/Cinna-Binna/bewarawIba/aswavyaswa/_avyavasWiwa
yaWAniyama	niyamAnusAra/yaWAniyama/bA-jAbwA
nArAjZagIpUrvaka	aprasannawApUrvaka/nArAjZagIpUrvaka/nAKZuSI_se/nArAjagIpUrvaka/nAKuSI_se
prawi_kRaNa	prawikRaNa/pala_pala/pala-pala/prawipala/hara_kRaNa/kRaNa-kRaNa/haraGadZI/hara_GadZI/prawi_kRaNa/kRaNakRaNa/anukRaNa/CinaCina/Cina-Cina/AKana
ekameva	akelA/akele/kevala/sirPZa/mAwra/KAlI/KZAlI/basa/nipata/mahajZa/sirPa/wanhA/wanahA/ekAkI/ekameva/ekaMga/ikelA
rojZAnA	prawixina/haraxina/niwya/hararojZa/rojZa/niwa/roja/rojZAnA/rojAnA/anuxina/niwyaprawi/anuxivasa/aharaha
TasATasa	TasATasa/TuzsATuzsa/KacAKaca/TusATusa
awiSIGra	Jatapata/catapata/PatAPata/wuraMwa/wuranwa/wawkAla/avilaMba/avilamba/PZOrana/POrana/KatAka_se/wawkRaNa/wadZAka_se/wadZa_se/wapAka_se/awiSIGra/awiSIGrawaH/jalxa_se_jalxa/jalxI_se_jalxI/wadZa_se/hAWoM-hAWa/hAWoM_hAWa/hAWo-hAWa/hAWo_hAWa/Kata_se/Anana-PAnana_meM/AnanaPAnana_meM/siwAba/siwAbI/besAKwA/TahAkA/ikahAI/ikahAU
anakarIba	aMxAjana/aMxAjZana/anxAjZana/anxAjana/lagaBaga/wakZarIbana/wakarIbana/kZarIba/karIba/karIbakarIba/karIbana/kZarIbakZarIba/kZarIbana/anumAnawaH/anakZarIba/anakarIba/waKZamInana/aMxAja_se/ukavAz
jabarana	balapUrvaka/barabasa/jZabaraxaswI/jabaraxaswI/jZabarana/jabarana/barajZorI
sPUrwipUrvaka	sPUrwipUrvaka/cuswI_se/PurwI_se/muswExI_se
kaBI-kaBI	kaBIkaBI/kaBIkaBAra/yaxAkaxA/kaBI-kaBI/kaBI-kaBAra/yaxA-kaxA/vakwan-POvakwan
svayaM	svayaM/svawaH/Kuxa/KZuxa/Apa/ApahI/apaneApa/KZuxa_hI/sAkRAw/sAkRAwa/asAlawana/AparUpa
hasba-e-mAmUla	hasbemAmUla/hasbe-mAmUla/hasba-e-mAmUla/hameSA_kI_waraha
sawkArapUrvaka	sawkArapUrvaka/sAxara/sasammAna/Axara_sahiwa
ke_BIwara	ke_aMxara/ke_anxara/ke_BIwara/meM
vASinxA	niHsaMxeha/nissaMxeha/jarUra/jZarUra/niHsanxeha/nissanxeha/nisaMxeha/nisanxeha/binA_Saka/beSaka/bilkula/bilakula/yakInana/yakZInana/avaSyameva/avaSya/alabawwA/bilASaka/aBarama/vASinxA/bASinxA/avasi/aviwarkika/asaMSaya/niSciwawaH/ikaMka
viXivaw	viXipUrvaka/kZAyaxe_se/DaMga_se/warIkZe_se/bawOra/bAkZAyaxA/viXivaw/viXivawa
asAvaXAnawaH	asAvaXAnawaH/asAvaXAnI_se/XyAnahInawaH/lAparavAhI_se
yakInana	niHsaMxeha/nissaMxeha/jarUra/jZarUra/niHsanxeha/nissanxeha/nisaMxeha/nisanxeha/binA_Saka/beSaka/bilkula/bilakula/yakInana/yakZInana/avaSyameva/avaSya/alabawwA/bilASaka/aBarama/vASinxA/bASinxA/avasi/aviwarkika/asaMSaya/niSciwawaH/ikaMka
XIme	XIre/XIme/hOle/Ahiswe/AhiswA/Ahiswe_se/AhiswA_se/Asawe/Aswe
haswacAliwa_DaMga_se	hAWa_se/hAWa_xvArA/haswacAliwa_DaMga_se/haswacAlana_xvArA
kqpA_pUrvaka	kqpayA/kqpApUrvaka/kqpA_pUrvaka/kqpA_karake/meharabAnI_karake
kahuz	kahIM/kahUz/kahuz/kahIM/kahUz/kahuz
nihAyawa	awyaMwa/awyanwa/awyaXika/be-iMwahA/beiMwahA/bahuwa_aXika/bahuwa_hI/bepanAha/saKZwa/saKwa/jamakara/mahA/nihAyawa/cUdZAMwa/cUdZAnwa/aByaXika/Agara
vicAriwawaH	soca-vicArakara/samaJa-bUJakara/vicArapUrvaka/soca-samaJakara/soca_vicAra_kara/samaJa_bUJa_kara/soca_samaJa_kara/vicAriwawaH
beJiJaka	nisaMkoca/niHsaMkoca/nissaMkoca/beXadZaka/saMkocahInawaH/beJiJaka/beKataka/beKatake/behicaka
aXOrxXa	Upara-nIce/aXoraXa/aXorXa/aXOrxXa
sapawnIka	sapawnIka
awiSIGrawaH	Jatapata/catapata/PatAPata/wuraMwa/wuranwa/wawkAla/avilaMba/avilamba/PZOrana/POrana/KatAka_se/wawkRaNa/wadZAka_se/wadZa_se/wapAka_se/awiSIGra/awiSIGrawaH/jalxa_se_jalxa/jalxI_se_jalxI/wadZa_se/hAWoM-hAWa/hAWoM_hAWa/hAWo-hAWa/hAWo_hAWa/Kata_se/Anana-PAnana_meM/AnanaPAnana_meM/siwAba/siwAbI/besAKwA/TahAkA/ikahAI/ikahAU
aBarama	niHsaMxeha/nissaMxeha/jarUra/jZarUra/niHsanxeha/nissanxeha/nisaMxeha/nisanxeha/binA_Saka/beSaka/bilkula/bilakula/yakInana/yakZInana/avaSyameva/avaSya/alabawwA/bilASaka/aBarama/vASinxA/bASinxA/avasi/aviwarkika/asaMSaya/niSciwawaH/ikaMka
viSvAsapUrvaka	viSvAsa_ke_sAWa/viSvasanIyawA_se/viSvAsapUrvaka
AjU-bAjU	Asa-pAsa/AsapAsa/agala-bagala/agZala-bagZala/AjU-bAjU/irxa-girxa/adZosa-padZosa/pAsa-padZosa/pAsa_padZosa
wirapata	wiraCA/wiryaka/AdZA/teDZA/bAzkA/wirapata
PilahAla	PilahAla/PZilahAla/aba/varwamAna_meM/Aja-kala/Ajakala/Aja_kala/AjakAla/ina_xinoM/isa_samaya/saMprawi/aBI/PZilahAla/PilahAla/isa_samaya/aba/aWa/aXunA/saMprawi/samprawi/aBU/aBE
wale	wale/nIce
apekRAkqwa	apekRAkqwa/wulanA_meM/apekRayA/mukZAbale/mukAbale/banisbawa/se
vApasa_se	xubArA/xobArA/Pira/Pira_se/punaH/eka_bAra_Pira/vApasa_se
prawiSawa	prawiSawa/PZIsaxI/PIsaxI/paraseMta
bahuXA	prAyaH/akasara/aksara/aXikawara/aXikAMSawaH/jyAxAwara/bahuXA/AmawOra_para/AmawOra_se/aXikAMSawayA/prAyaSaH/anekaXA
niHsaMxeha	niHsaMxeha/nissaMxeha/jarUra/jZarUra/niHsanxeha/nissanxeha/nisaMxeha/nisanxeha/binA_Saka/beSaka/bilkula/bilakula/yakInana/yakZInana/avaSyameva/avaSya/alabawwA/bilASaka/aBarama/vASinxA/bASinxA/avasi/aviwarkika/asaMSaya/niSciwawaH/ikaMka
PatAPata	Jatapata/catapata/PatAPata/wuraMwa/wuranwa/wawkAla/avilaMba/avilamba/PZOrana/POrana/KatAka_se/wawkRaNa/wadZAka_se/wadZa_se/wapAka_se/awiSIGra/awiSIGrawaH/jalxa_se_jalxa/jalxI_se_jalxI/wadZa_se/hAWoM-hAWa/hAWoM_hAWa/hAWo-hAWa/hAWo_hAWa/Kata_se/Anana-PAnana_meM/AnanaPAnana_meM/siwAba/siwAbI/besAKwA/TahAkA/ikahAI/ikahAU
kahIM	kahIM/kahUz/kahuz/kahIM/kahUz/kahuz/kahIM
XyAnahInawaH	asAvaXAnawaH/asAvaXAnI_se/XyAnahInawaH/lAparavAhI_se
kramaSaH	kramaSaH/kramAnusAra/yaWAkrama/silasilevAra/bArI-bArI_se/kramavAra/warawIbavAra/ayugapaxa/alpaSaH
joraxAra	kasakara/joraxAra/weja/wejZa/wIvra/wejZI_se/jZora_se/wejI_se/jora_se/wIvrawA_se
Ahiswe_se	XIre/XIme/hOle/Ahiswe/AhiswA/Ahiswe_se/AhiswA_se/Asawe/Aswe
KuxabaKuxa	svawaH/apaneApa/KZuxa-ba-KZuxa/KZuxabaKZuxa/Kuxa-ba-Kuxa/KuxabaKuxa
raMcamAwra	nAmamAwra/leSamAwra/raMcamAwra/WodZA_sA
waxauparAMwa	wawapaScAwa/waxanaMwara/waxauparAMwa/waxoparAMwa/waxaMwara/waxananwara/waxuparAMwa/waxuparAnwa/waxoparAMwa/waxoparAnwa/waxanwara
usI_waraha	vEse/vEsA/usI_waraha/usa_waraha/iva
TahAkA	Jatapata/catapata/PatAPata/wuraMwa/wuranwa/wawkAla/avilaMba/avilamba/PZOrana/POrana/KatAka_se/wawkRaNa/wadZAka_se/wadZa_se/wapAka_se/awiSIGra/awiSIGrawaH/jalxa_se_jalxa/jalxI_se_jalxI/wadZa_se/hAWoM-hAWa/hAWoM_hAWa/hAWo-hAWa/hAWo_hAWa/Kata_se/Anana-PAnana_meM/AnanaPAnana_meM/siwAba/siwAbI/besAKwA/TahAkA/ikahAI/ikahAU
mUlawaH	mUlawaH
abalaga	aba_waka/aBI_waka/Aja_waka/abawaka/aBIwaka/Ajawaka/ajahuz/ajahUz/ajo/ajOM/abalaga
punaH	xubArA/xobArA/Pira/Pira_se/punaH/eka_bAra_Pira/vApasa_se
jIvanaBara	mqwyuparyanwa/AjIvana/wAumra/umraBara/jZiMxagIBara/jiMxagIBara/jIvanaBara/AmaraNa/aMwima_xama_waka/Ajanma/jIvanaparyanwa/jIvanaBara
IMGe	yahAz/isa_jagaha/iwaH/iwa/iha/ihAz/ihavAz/IMGe/IhAz
waba	waba/usa_samaya/usa_vakwa/waba
Ara-pAra	Ara-pAra/ArapAra
Kuxa	svayaM/svawaH/Kuxa/KZuxa/Apa/ApahI/apaneApa/KZuxa_hI/sAkRAw/sAkRAwa/asAlawana/AparUpa
wiraCA	wiraCA/wiryaka/AdZA/teDZA/bAzkA/wirapata
mukZAbale	apekRAkqwa/wulanA_meM/apekRayA/mukZAbale/mukAbale/banisbawa/se
iwwaPZAkZana	acAnaka/ekAeka/sahasA/ekabAragI/ikabAragI/yakAyaka/akasmAwa/akasmAw/anAyAsa/xEvAw/xEvavaSa/Ocaka/aprawyASiwawaH/ApAwawaH/aMcakEM/agawyA/acaka/acAMcaka/acAkA/acAka/acAna/anAgawaH/anyAsa/nAgahAz/AcAna/ikahAI/ikahAU/iwwiPZAkZana/iwwiPAkana/iwwaPZAkZana/iwwaPAkana/ucakA/Ocaka/saMyogavaSa/iwwiPZAkZana/iwwiPAkana/iwwaPZAkZana/iwwaPAkana/saMyogavaSAw
nOgunA	nOgunA/navagunA
rima-Jima	rimaJima/rimaJima-rimaJima/rima-Jima
hasbemAmUla	hasbemAmUla/hasbe-mAmUla/hasba-e-mAmUla/hameSA_kI_waraha
aXo_xiSA_meM	nIce/aXaH/nimnawaH/aXo_xiSA_meM
AKana	prawikRaNa/pala_pala/pala-pala/prawipala/hara_kRaNa/kRaNa-kRaNa/haraGadZI/hara_GadZI/prawi_kRaNa/kRaNakRaNa/anukRaNa/CinaCina/Cina-Cina/AKana
xuganA	xugunA/xUnA/xogunA/xuganA/xviguNa/xviguNiwa
Kule-Ama	KuleAma/Kulakara/sareAma/sare-Ama/Kule-Ama/Kullama-KullA/KullamaKullA/daMke_kI_cota_para/sare_Ama/agupwawaH
vyarWa	vyarWa/PZajUla/PijUla/PZijUla/anerA/yoM_hI/vqWA/apArWa/bAxa-havAI/bAxahavAI/ahewu/ahewuka/aviraWA
xina-para-xina	xina-prawixina/xina-xina/xina-para-xina/xina-baxina/xina-ba_xina/xinaprawixina/xinaxina/xinabaxina/xinoM-xina/xinoMxina
acira	jalxI/SIGra/SIGrawaH/avilaMbawaH/jalxa/acira/wUrNa/SiwAba/begi/avalaMbiwa/avalambiwa/jalxI_se/ASu/avilaMbiwa/avilambiwa
bAXArahiwa	nirbAXa/bAXArahiwa/akaMtaka
ukurU	ukadZUz/ukadZU/ukadUz/ukadU/ukurU
jalxI_se_jalxI	Jatapata/catapata/PatAPata/wuraMwa/wuranwa/wawkAla/avilaMba/avilamba/PZOrana/POrana/KatAka_se/wawkRaNa/wadZAka_se/wadZa_se/wapAka_se/awiSIGra/awiSIGrawaH/jalxa_se_jalxa/jalxI_se_jalxI/wadZa_se/hAWoM-hAWa/hAWoM_hAWa/hAWo-hAWa/hAWo_hAWa/Kata_se/Anana-PAnana_meM/AnanaPAnana_meM/siwAba/siwAbI/besAKwA/TahAkA/ikahAI/ikahAU
varwamAna_meM	PilahAla/PZilahAla/aba/varwamAna_meM/Aja-kala/Ajakala/Aja_kala/AjakAla/ina_xinoM/isa_samaya/saMprawi
sahI-salAmawa	sakuSala/kuSalawApUrvaka/kuSalapUrvaka/sahI_salAmawa/sahI-salAmawa/TIka-TAka/TIka_se/TIka-TAka_se/TIkaTAka/baKZEra/baKEra/baKZErIya/baKErIyawa/surakRiwawaH
baxaswUra	niyamiwawaH/niyama_se/niyamAnusAra/baxaswUra/paraMparAnusAra/baxaswUra
iwarewara	paraspara/Apasa_meM/eka_xUsare_se/iwarewara
jabaraxaswI	balapUrvaka/barabasa/jZabaraxaswI/jabaraxaswI/jZabarana/jabarana/barajZorI
Jatake_se	Jatake_se/Jatake_ke_sAWa
apaneApa	svayaM/svawaH/Kuxa/KZuxa/Apa/ApahI/apaneApa/KZuxa_hI/sAkRAw/sAkRAwa/asAlawana/AparUpa/svawaH/apaneApa/KZuxa-ba-KZuxa/KZuxabaKZuxa/Kuxa-ba-Kuxa/KuxabaKuxa
bewarawIba	wiwara-biwara/aswa-vyaswa/Cinna-Binna/bewarawIba/aswavyaswa/_avyavasWiwa
KZAlI	akelA/akele/kevala/sirPZa/mAwra/KAlI/KZAlI/basa/nipata/mahajZa/sirPa/wanhA/wanahA/ekAkI/ekameva/ekaMga/ikelA
aSiRtawaH	asaByawaH/aSiRtawaH/SiRtAcArahInawaH
pahale_se_hI	pahale_se/pUrvawaH/pahale_se_hI
najIka	pAsa_meM/najZaxIka/najaxIka/nikata_meM/kZarIba_meM/samIpa/nikata/pAsa/kZarIba/karIba/sannikata/najIka/muwwasila/arvAka/avixUra/Are/AsapAsa/Asa-pAsa
KZAsawOra_se	viSeRakara/KZAsakara/KZAsa_wOra_para/KZAsa_wOra_se/KZAsawOra_para/KZAsawOra_se/KAsawOra_para/KAsawOra_se/KAsakara/viSeRawaH/viSiRtawaH/muKyawaH/viSeRa_rUpa_se
paryApwa	paryApwa/kAPI/kAPZI/yaWeRta/alam/alaM
jagaha-jagaha_para	jagaha-jagaha_para
BI	BI/BI
sirPZa	akelA/akele/kevala/sirPZa/mAwra/KAlI/KZAlI/basa/nipata/mahajZa/sirPa/wanhA/wanahA/ekAkI/ekameva/ekaMga/ikelA
pUrNarupeNa	bilkula/bilakula/ekaxama/nipata/sarAsara/TIka/niwAMwa/niwAnwa/pUrNawaH/pUrI_waraha_se/pUrNawayA/saMpUrNawaH/saMpUrNawayA/pUrNarupeNa/AmUlacUla/Sawa-prawiSawa
barajZorI	balapUrvaka/barabasa/jZabaraxaswI/jabaraxaswI/jZabarana/jabarana/barajZorI
wUrNa	jalxI/SIGra/SIGrawaH/avilaMbawaH/jalxa/acira/wUrNa/SiwAba/begi/avalaMbiwa/avalambiwa/jalxI_se/ASu/avilaMbiwa/avilambiwa
WodZA_WodZA	alpawaH/WodZA-WodZA/WodZA_WodZA/alpaSaH
kRamawAnusAra	yaWASakwi/Barasaka/yaWAsAXya/yaWAsaMBava/kRamawAnusAra/yaWAkRama
uxvignawApUrvaka	ciMwiwawaH/uxvignawaH/uxvignawApUrvaka
bina_mAzge	binamAzge/bina_mAzge/anamAzge/ayAciwawaH
karIbana	aMxAjana/aMxAjZana/anxAjZana/anxAjana/lagaBaga/wakZarIbana/wakarIbana/kZarIba/karIba/karIbakarIba/karIbana/kZarIbakZarIba/kZarIbana/anumAnawaH/anakZarIba/anakarIba/waKZamInana/aMxAja_se/ukavAz
aBIwaka	aba_waka/aBI_waka/Aja_waka/abawaka/aBIwaka/Ajawaka/ajahuz/ajahUz/ajo/ajOM/abalaga
yAciwawaH	mAzgakara/yAciwawaH
praWama	AraMBa_meM/AraMBawaH/AramBawaH/pahale/SurU_meM/praWama/Axi_meM/praWamawaH/sarvapraWama/pUrva/SuruAwa_meM/SuruvAwa_meM/AramBa_meM/prAramBa_meM
sareSAma	sareSAma
xinaprawixina	xina-prawixina/xina-xina/xina-para-xina/xina-baxina/xina-ba_xina/xinaprawixina/xinaxina/xinabaxina/xinoM-xina/xinoMxina
mqwyuparyanwa	mqwyuparyanwa/AjIvana/wAumra/umraBara/jZiMxagIBara/jiMxagIBara/jIvanaBara/AmaraNa/aMwima_xama_waka
bAzkA	wiraCA/wiryaka/AdZA/teDZA/bAzkA/wirapata
samUhawaH	samUhawaH/sAmUhika_rUpa_se
KZAsa_wOra_para	viSeRakara/KZAsakara/KZAsa_wOra_para/KZAsa_wOra_se/KZAsawOra_para/KZAsawOra_se/KAsawOra_para/KAsawOra_se/KAsakara/viSeRawaH/viSiRtawaH/muKyawaH/viSeRa_rUpa_se
arvAka	pAsa_meM/najZaxIka/najaxIka/nikata_meM/kZarIba_meM/samIpa/nikata/pAsa/kZarIba/karIba/sannikata/najIka/muwwasila/arvAka/avixUra/Are/AsapAsa/Asa-pAsa/pICe/paScawaH/pACe/pqRTawaH/arvAka
AgepICe	AgepICe/Age_pICe/Age-pICe/pUrvApara
saMprawi	PilahAla/PZilahAla/aba/varwamAna_meM/Aja-kala/Ajakala/Aja_kala/AjakAla/ina_xinoM/isa_samaya/saMprawi/aBI/PZilahAla/PilahAla/isa_samaya/aba/aWa/aXunA/saMprawi/samprawi/aBU/aBE
niwyaprawi	prawixina/haraxina/niwya/hararojZa/rojZa/niwa/roja/rojZAnA/rojAnA/anuxina/niwyaprawi/anuxivasa/aharaha
aspaRtawaH	aspaRtawaH/saMxigXawaH
SAnwa	cupacApa/cupa/mOna/SAMwa/SAnwa/KZAmoSI_se/KAmoSI_se/niSSabxa/avAka/avAk/bina_bole/mOnawaH
aMxAjana	aMxAjana/aMxAjZana/anxAjZana/anxAjana/lagaBaga/wakZarIbana/wakarIbana/kZarIba/karIba/karIbakarIba/karIbana/kZarIbakZarIba/kZarIbana/anumAnawaH/anakZarIba/anakarIba/waKZamInana/aMxAja_se/ukavAz
acAnaka	acAnaka/ekAeka/sahasA/ekabAragI/ikabAragI/yakAyaka/akasmAwa/akasmAw/anAyAsa/xEvAw/xEvavaSa/Ocaka/aprawyASiwawaH/ApAwawaH/aMcakEM/agawyA/acaka/acAMcaka/acAkA/acAka/acAna/anAgawaH/anyAsa/nAgahAz/AcAna/ikahAI/ikahAU/iwwiPZAkZana/iwwiPAkana/iwwaPZAkZana/iwwaPAkana/ucakA/Ocaka
parAXInawaH	parAXInawaH/aXInawA_meM/paravaSawaH
karIbakarIba	aMxAjana/aMxAjZana/anxAjZana/anxAjana/lagaBaga/wakZarIbana/wakarIbana/kZarIba/karIba/karIbakarIba/karIbana/kZarIbakZarIba/kZarIbana/anumAnawaH/anakZarIba/anakarIba/waKZamInana/aMxAja_se/ukavAz
BalIBAMwi	BalI-BAzwi/BalI_BAzwi/BarapUra/BalIBAzwi/BalI-BAMwi/BalI_BAMwi/BalIBAMwi/sarvawoBAva/acCI_waraha
peSa	peSa/hAjZira/hAjira
iwaH	iXara/isa_ora/yahAz_para/iwaH/iwa/iwE/iwWe/yahAz/isa_jagaha/iwaH/iwa/iha/ihAz/ihavAz/IMGe/IhAz
subaha_savere	sabere/savere/subaha/wadZake/subaha-subaha/subaha_savere
AkarNa	AkarNa
SOkiyA	SOkiyA
uwana	uXara/usa_ora/pare/uwa/uwana
pAsa_meM	pAsa_meM/najZaxIka/najaxIka/nikata_meM/kZarIba_meM/samIpa/nikata/pAsa/kZarIba/karIba/sannikata/najIka/muwwasila/arvAka/avixUra/Are/AsapAsa/Asa-pAsa
BalI-BAzwi	BalI-BAzwi/BalI_BAzwi/BarapUra/BalIBAzwi/BalI-BAMwi/BalI_BAMwi/BalIBAMwi/sarvawoBAva/acCI_waraha
usI_samaya	waBI/waba_hI/usI_samaya/usI_GadZI
bagatuta	bagaCuta/bagatuta
sarasarI	sarasarI
sAmAnyawayA	sAmAnyawaH/sAmAnyawayA/sAXAraNawaH/sAXAraNawayA/amUmana/umUmana
kAPZI	bahuwa/KZUba/KUba/badZA/jyAxA/jZyAxA/aXika/kAPZI/kAPI/kadZA/jamakara/datakara/paryApwa/kAPI/kAPZI/yaWeRta/alam/alaM
waxanaMwara	wawapaScAwa/waxanaMwara/waxauparAMwa/waxoparAMwa/waxaMwara/waxananwara/waxuparAMwa/waxuparAnwa/waxoparAMwa/waxoparAnwa/waxanwara
aba_waka	aba_waka/aBI_waka/Aja_waka/abawaka/aBIwaka/Ajawaka/ajahuz/ajahUz/ajo/ajOM/abalaga
aXaH	nIce/aXaH/nimnawaH/aXo_xiSA_meM
gZalawa_samaya_para	asamaya/bevakZwa/bevakwa/gZalawa_samaya_para/galawa_samaya_para/bemOke
awyaMwa	awyaMwa/awyanwa/awyaXika/be-iMwahA/beiMwahA/bahuwa_aXika/bahuwa_hI/bepanAha/saKZwa/saKwa/jamakara/mahA/nihAyawa/cUdZAMwa/cUdZAnwa/aByaXika/Agara
kqpA_kara_ke	xayApUrvaka/kqpA_kara_ke/kqpApUrvaka/xayA_se/barAe_meharabAnI
Age_kI_ora	Age-Age/Age_kI_ora/sabase_pahale
ukadZUz	ukadZUz/ukadZU/ukadUz/ukadU/ukurU
waxaMwara	wawapaScAwa/waxanaMwara/waxauparAMwa/waxoparAMwa/waxaMwara/waxananwara/waxuparAMwa/waxuparAnwa/waxoparAMwa/waxoparAnwa/waxanwara
aMwarjAnu	aMwarjAnu/anwarjAnu
saxeha	saxeha/saSarIra
catapata	Jatapata/catapata/PatAPata/wuraMwa/wuranwa/wawkAla/avilaMba/avilamba/PZOrana/POrana/KatAka_se/wawkRaNa/wadZAka_se/wadZa_se/wapAka_se/awiSIGra/awiSIGrawaH/jalxa_se_jalxa/jalxI_se_jalxI/wadZa_se/hAWoM-hAWa/hAWoM_hAWa/hAWo-hAWa/hAWo_hAWa/Kata_se/Anana-PAnana_meM/AnanaPAnana_meM/siwAba/siwAbI/besAKwA/TahAkA/ikahAI/ikahAU
AScaryapUrvaka	AScaryapUrvaka/savismaya/sAScarya
KZuxa_hI	svayaM/svawaH/Kuxa/KZuxa/Apa/ApahI/apaneApa/KZuxa_hI/sAkRAw/sAkRAwa/asAlawana/AparUpa
beiMwahA	awyaMwa/awyanwa/awyaXika/be-iMwahA/beiMwahA/bahuwa_aXika/bahuwa_hI/bepanAha/saKZwa/saKwa/jamakara/mahA/nihAyawa/cUdZAMwa/cUdZAnwa/aByaXika/Agara
samAMwara	samAMwara/samAnAMwara/samAnwara/samAnAnwara
hAWoM-hAWa	Jatapata/catapata/PatAPata/wuraMwa/wuranwa/wawkAla/avilaMba/avilamba/PZOrana/POrana/KatAka_se/wawkRaNa/wadZAka_se/wadZa_se/wapAka_se/awiSIGra/awiSIGrawaH/jalxa_se_jalxa/jalxI_se_jalxI/wadZa_se/hAWoM-hAWa/hAWoM_hAWa/hAWo-hAWa/hAWo_hAWa/Kata_se/Anana-PAnana_meM/AnanaPAnana_meM/siwAba/siwAbI/besAKwA/TahAkA/ikahAI/ikahAU
kaTinawaH	kaTinAI_se/jEse_wEse/muSkila_se/bamuSkila/kaTinawaH/nITi
avirawa	lagAwAra/anavarawa/niraMwara/niranwara/wAbadZawodZa/xanAxana/sawawa/XUAzXAra/anaMwara/ananwara/avirAmawaH/aniSa/prawikRaNa/anukRaNa/XadZAXadZa/avirawa/muwwasila/avicCinna/avicCexa/aviSrAnwa/aviSrAMwa/asarAra/aharaha/AsaMga/Asafga/ikawAra
sarapata	sarapata
avalambiwa	jalxI/SIGra/SIGrawaH/avilaMbawaH/jalxa/acira/wUrNa/SiwAba/begi/avalaMbiwa/avalambiwa/jalxI_se/ASu/avilaMbiwa/avilambiwa
xarSanArWa	xarSanArWa
avilambiwa	jalxI/SIGra/SIGrawaH/avilaMbawaH/jalxa/acira/wUrNa/SiwAba/begi/avalaMbiwa/avalambiwa/jalxI_se/ASu/avilaMbiwa/avilambiwa
jAzca_paraKakara	jAzca_paraKakara/jAzca_paraKa_kara
amUmana	sAmAnyawaH/sAmAnyawayA/sAXAraNawaH/sAXAraNawayA/amUmana/umUmana
kZarInAvAra	warIkZe_se/warIke_se/warawIba_se/kZarIne_se/karIne_se/vyavasWApUrvaka/vyavasWiwawaH/kZarInAvAra/karInAvAra
ucakA	acAnaka/ekAeka/sahasA/ekabAragI/ikabAragI/yakAyaka/akasmAwa/akasmAw/anAyAsa/xEvAw/xEvavaSa/Ocaka/aprawyASiwawaH/ApAwawaH/aMcakEM/agawyA/acaka/acAMcaka/acAkA/acAka/acAna/anAgawaH/anyAsa/nAgahAz/AcAna/ikahAI/ikahAU/iwwiPZAkZana/iwwiPAkana/iwwaPZAkZana/iwwaPAkana/ucakA/Ocaka
pravAha_kI_ora	pravAha_kI_xiSA_meM/pravAha_kI_ora
aBimAnapUrvaka	aBimAnapUrvaka/aBimAna_se/sagarva/sABimAna
SAlInawaH	SiRtawaH/saByawaH/bAsaUra/SAlInawaH/SiRtAcArapUrvaka/salIkZe_se
yaxA-kaxA	kaBIkaBI/kaBIkaBAra/yaxAkaxA/kaBI-kaBI/kaBI-kaBAra/yaxA-kaxA/vakwan-POvakwan
vilaMbawaH	vilaMbawaH/aSIGrawaH/xerI_se/vilaMbapUrvaka/xera_meM
sirPa	akelA/akele/kevala/sirPZa/mAwra/KAlI/KZAlI/basa/nipata/mahajZa/sirPa/wanhA/wanahA/ekAkI/ekameva/ekaMga/ikelA
KAsawOra_para	viSeRakara/KZAsakara/KZAsa_wOra_para/KZAsa_wOra_se/KZAsawOra_para/KZAsawOra_se/KAsawOra_para/KAsawOra_se/KAsakara/viSeRawaH/viSiRtawaH/muKyawaH/viSeRa_rUpa_se
corI_Cipe	gupwawaH/gupacupa_rUpa_se/corI_Cipe
BUwa_kAla_meM	awIwa_meM/pahale/BUwa_meM/BUwa_kAla_meM/pICe/piCale_xinoM_meM
samIpa	pAsa_meM/najZaxIka/najaxIka/nikata_meM/kZarIba_meM/samIpa/nikata/pAsa/kZarIba/karIba/sannikata/najIka/muwwasila/arvAka/avixUra/Are/AsapAsa/Asa-pAsa
prawipala	prawikRaNa/pala_pala/pala-pala/prawipala/hara_kRaNa/kRaNa-kRaNa/haraGadZI/hara_GadZI/prawi_kRaNa/kRaNakRaNa/anukRaNa/CinaCina/Cina-Cina/AKana
Age-Age	Age-Age/Age_kI_ora/sabase_pahale
wigunA	wigunA/wInagunA/wIna_gunA
beKatake	niSciMwawaH/ciMwAhInawaH/beKatake/nisaMkoca/niHsaMkoca/nissaMkoca/beXadZaka/saMkocahInawaH/beJiJaka/beKataka/beKatake/behicaka
beKataka	nisaMkoca/niHsaMkoca/nissaMkoca/beXadZaka/saMkocahInawaH/beJiJaka/beKataka/beKatake/behicaka
datakara	bahuwa/KZUba/KUba/badZA/jyAxA/jZyAxA/aXika/kAPZI/kAPI/kadZA/jamakara/datakara
agara	yaxi/agara/jaba
waWApi	Pira_BI/waWApi/waba_BI
IsA_paScAw	IsA_paScAw/I_pa/edI/IsA_paScAw/IsA_paScAw/I_pa/edI/IsA_paScAw
wanika	jarA/jZarA/jarA-sA/jZarA-sA/rawwiBara/WodZA/WodZA-sA/WodZA_sA/wanika/yawkiMciw
karIba	pAsa_meM/najZaxIka/najaxIka/nikata_meM/kZarIba_meM/samIpa/nikata/pAsa/kZarIba/karIba/sannikata/najIka/muwwasila/arvAka/avixUra/Are/AsapAsa/Asa-pAsa/aMxAjana/aMxAjZana/anxAjZana/anxAjana/lagaBaga/wakZarIbana/wakarIbana/kZarIba/karIba/karIbakarIba/karIbana/kZarIbakZarIba/kZarIbana/anumAnawaH/anakZarIba/anakarIba/waKZamInana/aMxAja_se/ukavAz
agZala-bagZala	Asa-pAsa/AsapAsa/agala-bagala/agZala-bagZala/AjU-bAjU/irxa-girxa/adZosa-padZosa/pAsa-padZosa/pAsa_padZosa
