an	eka/koI
a	eka/koI
vast	viswqwa
theory	siXxAMwa
fascinate	sammohiwa_kara
night	rAwri/rAwa
method	viXi/praNAlI
physics	BOwikI
to	ke_liye/kA
neither	na_wo
nor	na_hI
and	evaM
much	kAPI
around	ke_pariwaH/ke_iXara_uXara
financial	viwwa_saMbaMXiwa
accounting	leKAMkana
record-keeping	hisAba-kiwAb
however	waWApi
early	Axya
diverge	apasariwa
happen	pariNAma_ho
assume	mAnakara_cala
mechanism	yaMwra_vyavasWA
rotational	GUrNana
pioneer	paWa_praxarSaka
propagation	saFcaraNa
paraxial	upAkRIya
object	bimba
quantity	rASi
elastic	prawyAsWa
theorist	sixXAnwavAxI
least	sabase_kama
raindrop	varRA_kI_bUzxa
sunlight	sUrya_kA_prakASa/sUrya_ke_prakASa
refract	apavarwiwa_ho/apavarwiwa_kara
therefore	isa_prakAra
debate	vAxa_vivAxa
of	meM_se
relax	SiWila_ho
enormous	awyaXika
straight	sarala
travel	gamana_kara
construction	racanA
rectilinear	sarala_reKA
along	ke_anuxiSa
real-life	vAswavika_jIvana meM
such	isa_prakAra_kA/isa_prakAra_kI/EsA_hI
thus	awaeva
everywhere	hara_sWAna_para
every	hareka
friction	GarRaNa_bala	
breeze	manxa_pavana
preceding	piCale
signal	safkewa_xe
likewise	isI_prakAra
retard	manxa_kara
distance	xUra
wait	iMwajAra_kara
beat	parAjiwa_kara/parAjiwa_ho
similarly	isI_prakAra
handle	hala_kara
impending	samupasWiwa
thereby	jisake_PalasvarUpa
etc.	Axi
many	bahuwa_sI
clearly	spaRta_hE_ki
move	gawi_kara/gawiSIla_kara
only	eka_hI
management	praSAsana 
telly	telIvijana
workplace	xaPwara_ke_kAmakAja
let	Aie
return	vicAra_kara
accompany	saMlagna_ho
learn	aXyayana_kara
indicate	ifgiwa_kara/cihniwa_kara
astonish	AScaryacakiwa_kara
include	sammiliwa_ho
same	samAna
describe	vyAKyA_kara/vyakwa_kara/nirUpaNa
familiar	supariciwa
unify	ekIkqwa_kara
underlie	mUla_meM_ho
obviously	spaRta_hE_ki
introduce	praswuwa_kara
enormously	kahIM_aXika
bind	bAnXe_raKa
recent	piCalA
foundation	mUlAXAra
report	praswuwa_kara
involve	sammiliwa_ho/nihiwa_ho
accelerate	wvariwa_ho
represent	vyakwa_kara/vyakwa_ho
establish	prawipAxiwa_kara
as	nimna_prakAra/jEsA_ki
look	xiKalAI_xe
specify	nirXAraNa
solve	prApwa_kara
motion	gawimAna
fig.	ciwra
then	Pira
uniformly	ekasamAna_rUpa_se
course	avaXi
correspond	waxanurUpa
convention	paxXawi
section	KaNda
show	praxarSiwa_kara
total	yoga
suppose	yaxi
constant	acara
binary	bAyanarI
disintegrate	viKaNdiwa_ho
fix	sWira/sWira_banA
Fig.	ciwra
prominent	muKya
movement	GUma
pith	sarakaNdA
sum	yogaPala
half	arXaBAga
he	yaha
change	parivarwiwa_ho
importance	mahawwA
me	mEM
mine	mEM
helpful	maxaxagAra
finish	Kawma_kara
yes	jI_hAz	
or	va
