0,f,p,a	KA
0,f,p,m	KA
0,f,p,u	KA
0,f,s,a	KA
0,f,s,m	KA
0,f,s,u	KA
0,m,p,a	KA
0,m,p,m	KA
0,m,p,u	KA
0,m,s,a	KA
0,m,s,m	KA
0,m,s,u	KA

0_cukA,f,p,a	cukIM
0_cukA,f,p,m	cukIM
0_cukA,f,p,u	cukIM
0_cukA,f,s,a	cukI
0_cukA,f,s,m	cukI
0_cukA,f,s,u	cukI
0_cukA,m,p,a	cuke
0_cukA,m,p,m	cuke
0_cukA,m,p,u	cuke
0_cukA,m,s,a	cukA
0_cukA,m,s,m	cukA
0_cukA,m,s,u	cukA

0_cukA_hE,f,p,a	cukIM_hEM
0_cukA_hE,f,p,m	cukIM_ho
0_cukA_hE,f,p,u	cukIM_hEM
0_cukA_hE,f,s,a	cukI_hE
0_cukA_hE,f,s,m	cukI_hE
0_cukA_hE,f,s,u	cukI_hUz
0_cukA_hE,m,p,a	cuke_hEM
0_cukA_hE,m,p,m	cuke_ho
0_cukA_hE,m,p,u	cuke_hEM
0_cukA_hE,m,s,a	cukA_hE
0_cukA_hE,m,s,m	cukA_hE
0_cukA_hE,m,s,u	cukA_hUz

0_cukA_hogA,f,p,a	cukIM_hoMgI
0_cukA_hogA,f,p,m	cukIM_hoogI
0_cukA_hogA,f,p,u	cukIM_hoMgI
0_cukA_hogA,f,s,a	cukI_hogI
0_cukA_hogA,f,s,m	cukI_hogI
0_cukA_hogA,f,s,u	cukI_hoUzgI
0_cukA_hogA,m,p,a	cuke_hoMge
0_cukA_hogA,m,p,m	cuke_hoge
0_cukA_hogA,m,p,u	cuke_hoMge
0_cukA_hogA,m,s,a	cukA_hogA
0_cukA_hogA,m,s,m	cukA_hogA
0_cukA_hogA,m,s,u	cukA_hoUzgA

0_cukA_WA,f,p,a	cukIM_WIM
0_cukA_WA,f,p,m	cukIM_WIM
0_cukA_WA,f,p,u	cukIM_WIM
0_cukA_WA,f,s,a	cukI_WI
0_cukA_WA,f,s,m	cukI_WI
0_cukA_WA,f,s,u	cukI_WI
0_cukA_WA,m,p,a	cuke_We
0_cukA_WA,m,p,m	cuke_We
0_cukA_WA,m,p,u	cuke_We
0_cukA_WA,m,s,a	cukA_WA
0_cukA_WA,m,s,m	cukA_WA
0_cukA_WA,m,s,u	cukA_WA

0_cukane_ke_bAxa,f,p,a	cukane_ke_bAxa
0_cukane_ke_bAxa,f,p,m	cukane_ke_bAxa
0_cukane_ke_bAxa,f,p,u	cukane_ke_bAxa
0_cukane_ke_bAxa,f,s,a	cukane_ke_bAxa
0_cukane_ke_bAxa,f,s,m	cukane_ke_bAxa
0_cukane_ke_bAxa,f,s,u	cukane_ke_bAxa
0_cukane_ke_bAxa,m,p,a	cukane_ke_bAxa
0_cukane_ke_bAxa,m,p,m	cukane_ke_bAxa
0_cukane_ke_bAxa,m,p,u	cukane_ke_bAxa
0_cukane_ke_bAxa,m,s,a	cukane_ke_bAxa
0_cukane_ke_bAxa,m,s,m	cukane_ke_bAxa
0_cukane_ke_bAxa,m,s,u	cukane_ke_bAxa

0_gayA_WA,f,p,a	gayIM_WIM
0_gayA_WA,f,p,m	gayIM_WIM
0_gayA_WA,f,p,u	gayIM_WIM
0_gayA_WA,f,s,a	gayI_WI
0_gayA_WA,f,s,m	gayI_WI
0_gayA_WA,f,s,u	gayI_WI
0_gayA_WA,m,p,a	gaye_We
0_gayA_WA,m,p,m	gaye_We
0_gayA_WA,m,p,u	gaye_We
0_gayA_WA,m,s,a	gayA_WA
0_gayA_WA,m,s,m	gayA_WA
0_gayA_WA,m,s,u	gayA_WA

0_ho_jAwA_hE,f,p,a	0_ho_jAwA_hE
0_ho_jAwA_hE,f,p,m	0_ho_jAwA_hE
0_ho_jAwA_hE,f,p,u	0_ho_jAwA_hE
0_ho_jAwA_hE,f,s,a	0_ho_jAwA_hE
0_ho_jAwA_hE,f,s,m	0_ho_jAwA_hE
0_ho_jAwA_hE,f,s,u	0_ho_jAwA_hE
0_ho_jAwA_hE,m,p,a	0_ho_jAwA_hE
0_ho_jAwA_hE,m,p,m	0_ho_jAwA_hE
0_ho_jAwA_hE,m,p,u	0_ho_jAwA_hE
0_ho_jAwA_hE,m,s,a	0_ho_jAwA_hE
0_ho_jAwA_hE,m,s,m	0_ho_jAwA_hE
0_ho_jAwA_hE,m,s,u	0_ho_jAwA_hE

0_jAyegA,f,p,a	jAezgI
0_jAyegA,f,p,m	jAogI
0_jAyegA,f,p,u	jAezgI
0_jAyegA,f,s,a	jAegI
0_jAyegA,f,s,m	jAogI
0_jAyegA,f,s,u	jAUzgI
0_jAyegA,m,p,a	jAezge
0_jAyegA,m,p,m	jAoge
0_jAyegA,m,p,u	jAezge
0_jAyegA,m,s,a	jAegA
0_jAyegA,m,s,m	jAegA
0_jAyegA,m,s,u	jAUzgA

0_jAnA_cAhiye,f,p,a	jAnA_cAhiye
0_jAnA_cAhiye,f,p,m	jAnA_cAhiye
0_jAnA_cAhiye,f,p,u	jAnA_cAhiye
0_jAnA_cAhiye,f,s,a	jAnA_cAhiye
0_jAnA_cAhiye,f,s,m	jAnA_cAhiye
0_jAnA_cAhiye,f,s,u	jAnA_cAhiye
0_jAnA_cAhiye,m,p,a	jAnA_cAhiye
0_jAnA_cAhiye,m,p,m	jAnA_cAhiye
0_jAnA_cAhiye,m,p,u	jAnA_cAhiye
0_jAnA_cAhiye,m,s,a	jAnA_cAhiye
0_jAnA_cAhiye,m,s,m	jAnA_cAhiye
0_jAnA_cAhiye,m,s,u	jAnA_cAhiye

0_kara,f,p,a	kara
0_kara,f,p,m	kara
0_kara,f,p,u	kara
0_kara,f,s,a	kara
0_kara,f,s,m	kara
0_kara,f,s,u	kara
0_kara,m,p,a	kara
0_kara,m,p,m	kara
0_kara,m,p,u	kara
0_kara,m,s,a	kara
0_kara,m,s,m	kara
0_kara,m,s,u	kara

0_liyA_hogA,f,p,a	lIM_hoMgI
0_liyA_hogA,f,p,m	lIM_hoMgI
0_liyA_hogA,f,p,u	lIM_hoMgI
0_liyA_hogA,f,s,a	lI_hogI
0_liyA_hogA,f,s,m	lI_hogI
0_liyA_hogA,f,s,u	lI_hogI
0_liyA_hogA,m,p,a	liye_hoMge
0_liyA_hogA,m,p,m	liye_hoMge
0_liyA_hogA,m,p,u	liye_hoMge
0_liyA_hogA,m,s,a	liyA_hogA
0_liyA_hogA,m,s,m	liyA_hogA
0_liyA_hogA,m,s,u	liyA_hogA

0_pAyegA,f,p,a	pAyeMgI
0_pAyegA,f,p,m	pAogI
0_pAyegA,f,p,u	pAyeMgI
0_pAyegA,f,s,a	pAyegI
0_pAyegA,f,s,m	pAyegI
0_pAyegA,f,s,u	pAUzgI
0_pAyegA,m,p,a	pAyeMge
0_pAyegA,m,p,m	pAoge
0_pAyegA,m,p,u	pAUzgA
0_pAyegA,m,s,a	pAyegA
0_pAyegA,m,s,m	pAyegA
0_pAyegA,m,s,u	pAUzgA

0_pAwA_wA,f,p,a	pAwI_WIM
0_pAwA_wA,f,p,m	pAwI_WIM
0_pAwA_wA,f,p,u	pAwI_WIM
0_pAwA_wA,f,s,a	pAwI_WI
0_pAwA_wA,f,s,m	pAwI_WI
0_pAwA_wA,f,s,u	pAwI_WI
0_pAwA_wA,m,p,a	pAwe_We
0_pAwA_wA,m,p,m	pAwe_We
0_pAwA_wA,m,p,u	pAwe_We
0_pAwA_wA,m,s,a	pAwA_WA
0_pAwA_wA,m,s,m	pAwA_WA
0_pAwA_wA,m,s,u	pAwA_WA

0_pAwA_hE,f,p,a	pAwI_hEM
0_pAwA_hE,f,p,m	pAwI_ho
0_pAwA_hE,f,p,u	pAwI_hEM
0_pAwA_hE,f,s,a	pAwI_hE
0_pAwA_hE,f,s,m	pAwI_hE
0_pAwA_hE,f,s,u	pAwI_hUz
0_pAwA_hE,m,p,a	pAwe_hEM
0_pAwA_hE,m,p,m	pAwe_ho
0_pAwA_hE,m,p,u	pAwe_hEM
0_pAwA_hE,m,s,a	pAwA_hE
0_pAwA_hE,m,s,m	pAwA_hE
0_pAwA_hE,m,s,u	pAwA_hUz

0_rahA_hE,f,p,a	rahIM_hEM
0_rahA_hE,f,p,m	rahIM_ho
0_rahA_hE,f,p,u	rahIM_hEM
0_rahA_hE,f,s,a	rahI_hE
0_rahA_hE,f,s,m	rahI_hE
0_rahA_hE,f,s,u	rahI_hUz
0_rahA_hE,m,p,a	rahe_hEM
0_rahA_hE,m,p,m	rahe_ho
0_rahA_hE,m,p,u	rahe_hEM
0_rahA_hE,m,s,a	rahA_hE
0_rahA_hE,m,s,m	rahA_hE
0_rahA_hE,m,s,u	rahA_hUz

0_rahA_WA,f,p,a	rahIM_WIM
0_rahA_WA,f,p,m	rahIM_WIM
0_rahA_WA,f,p,u	rahIM_WIM
0_rahA_WA,f,s,a	rahI_WI
0_rahA_WA,f,s,m	rahI_WI
0_rahA_WA,f,s,u	rahI_WI
0_rahA_WA,m,p,a	rahe_We
0_rahA_WA,m,p,m	rahe_We
0_rahA_WA,m,p,u	rahe_We
0_rahA_WA,m,s,a	rahA_WA
0_rahA_WA,m,s,m	rahA_WA
0_rahA_WA,m,s,u	rahA_WA

0_rahA_hogA,f,p,a	rahIM_hoMgI
0_rahA_hogA,f,p,m	rahIM_hoogI
0_rahA_hogA,f,p,u	rahIM_hoMgI
0_rahA_hogA,f,s,a	rahI_hogI
0_rahA_hogA,f,s,m	rahI_hogI
0_rahA_hogA,f,s,u	rahI_hoUzgI
0_rahA_hogA,m,p,a	rahe_hoMge
0_rahA_hogA,m,p,m	rahe_hoge
0_rahA_hogA,m,p,u	rahe_hoMge
0_rahA_hogA,m,s,a	rahA_hogA
0_rahA_hogA,m,s,m	rahA_hogA
0_rahA_hogA,m,s,u	rahA_hoUzgA

0_sakA,f,p,a	sakIM
0_sakA,f,p,m	sakIM
0_sakA,f,p,u	sakIM
0_sakA,f,s,a	sakI
0_sakA,f,s,m	sakI
0_sakA,f,s,u	sakI
0_sakA,m,p,a	sake
0_sakA,m,p,m	sake
0_sakA,m,p,u	sake
0_sakA,m,s,a	sakA
0_sakA,m,s,m	sakA
0_sakA,m,s,u	sakA

0_sakawA,f,p,a	sakawIM
0_sakawA,f,p,m	sakawIM
0_sakawA,f,p,u	sakawIM
0_sakawA,f,s,a	sakawI
0_sakawA,f,s,m	sakawI
0_sakawA,f,s,u	sakawI
0_sakawA,m,p,a	sakawe
0_sakawA,m,p,m	sakawe
0_sakawA,m,p,u	sakawe
0_sakawA,m,s,a	sakawA
0_sakawA,m,s,m	sakawA
0_sakawA,m,s,u	sakawA

0_sakawA_hE,f,p,a	sakawIM_hEM
0_sakawA_hE,f,p,m	sakawIM_ho
0_sakawA_hE,f,p,u	sakawIM_hEM
0_sakawA_hE,f,s,a	sakawI_hE
0_sakawA_hE,f,s,m	sakawI_hE
0_sakawA_hE,f,s,u	sakawI_hUz
0_sakawA_hE,m,p,a	sakawe_hEM
0_sakawA_hE,m,p,m	sakawe_ho
0_sakawA_hE,m,p,u	sakawe_hEM
0_sakawA_hE,m,s,a	sakawA_hE
0_sakawA_hE,m,s,m	sakawA_hE
0_sakawA_hE,m,s,u	sakawA_hUz

0_sakawA_WA,f,p,a	sakawIM_WIM
0_sakawA_WA,f,p,m	sakawIM_WIM
0_sakawA_WA,f,p,u	sakawIM_WIM
0_sakawA_WA,f,s,a	sakawI_WI
0_sakawA_WA,f,s,m	sakawI_WI
0_sakawA_WA,f,s,u	sakawI_WI
0_sakawA_WA,m,p,a	sakawe_We
0_sakawA_WA,m,p,m	sakawe_We
0_sakawA_WA,m,p,u	sakawe_We
0_sakawA_WA,m,s,a	sakawA_WA
0_sakawA_WA,m,s,m	sakawA_WA
0_sakawA_WA,m,s,u	sakawA_WA

wA_rahawA_hE,f,p,a	wI_rahawI_hEM
wA_rahawA_hE,f,p,m	wI_rahawI_ho
wA_rahawA_hE,f,p,u	wI_rahawI_hEM
wA_rahawA_hE,f,s,a	wI_rahawI_hE
wA_rahawA_hE,f,s,m	wI_rahawI_ho
wA_rahawA_hE,f,s,u	wI_rahawI_hUM
wA_rahawA_hE,m,p,a	we_rahawe_hEM
wA_rahawA_hE,m,p,m	we_rahawe_ho
wA_rahawA_hE,m,p,u	we_rahawe_hEM
wA_rahawA_hE,m,s,a	wA_rahawA_hE
wA_rahawA_hE,m,s,m	wA_rahawA_hE
wA_rahawA_hE,m,s,u	wA_rahawA_hUM

0_xenA_padA,f,p,a	0_xenA_padA
0_xenA_padA,f,p,m	0_xenA_padA
0_xenA_padA,f,p,u	0_xenA_padA
0_xenA_padA,f,s,a	0_xenA_padA
0_xenA_padA,f,s,m	0_xenA_padA
0_xenA_padA,f,s,u	0_xenA_padA
0_xenA_padA,m,p,a	0_xenA_padA
0_xenA_padA,m,p,m	0_xenA_padA
0_xenA_padA,m,p,u	0_xenA_padA
0_xenA_padA,m,s,a	0_xenA_padA
0_xenA_padA,m,s,m	0_xenA_padA
0_xenA_padA,m,s,u	0_xenA_padA

hE,f,p,a	hEM
hE,f,p,m	ho
hE,f,p,u	hEM
hE,f,s,a	hE
hE,f,s,m	hE
hE,f,s,u	hUz
hE,m,p,a	hEM
hE,m,p,m	ho
hE,m,p,u	hEM
hE,m,s,a	hE
hE,m,s,m	hE
hE,m,s,u	hUz

nahIM,f,p,a	nahIM
nahIM,f,p,m	nahIM
nahIM,f,p,u	nahIM
nahIM,f,s,a	nahIM
nahIM,f,s,m	nahIM
nahIM,f,s,u	nahIM
nahIM,m,p,a	nahIM
nahIM,m,p,m	nahIM
nahIM,m,p,u	nahIM
nahIM,m,s,a	nahIM
nahIM,m,s,m	nahIM
nahIM,m,s,u	nahIM

nahIM_padA,f,p,a	nahIM_padA
nahIM_padA,f,p,m	nahIM_padA
nahIM_padA,f,p,u	nahIM_padA
nahIM_padA,f,s,a	nahIM_padA
nahIM_padA,f,s,m	nahIM_padA
nahIM_padA,f,s,u	nahIM_padA
nahIM_padA,m,p,a	nahIM_padA
nahIM_padA,m,p,m	nahIM_padA
nahIM_padA,m,p,u	nahIM_padA
nahIM_padA,m,s,a	nahIM_padA
nahIM_padA,m,s,m	nahIM_padA
nahIM_padA,m,s,u	nahIM_padA

nahIM_padawA_WA,f,p,a	nahIM_padawA_WA
nahIM_padawA_WA,f,p,m	nahIM_padawA_WA
nahIM_padawA_WA,f,p,u	nahIM_padawA_WA
nahIM_padawA_WA,f,s,a	nahIM_padawA_WA
nahIM_padawA_WA,f,s,m	nahIM_padawA_WA
nahIM_padawA_WA,f,s,u	nahIM_padawA_WA
nahIM_padawA_WA,m,p,a	nahIM_padawA_WA
nahIM_padawA_WA,m,p,m	nahIM_padawA_WA
nahIM_padawA_WA,m,p,u	nahIM_padawA_WA
nahIM_padawA_WA,m,s,a	nahIM_padawA_WA
nahIM_padawA_WA,m,s,m	nahIM_padawA_WA
nahIM_padawA_WA,m,s,u	nahIM_padawA_WA

nA_hE,f,p,a	hEM
nA_hE,f,p,m	hEM
nA_hE,f,p,u	hEM
nA_hE,f,s,a	hE
nA_hE,f,s,m	hE
nA_hE,f,s,u	hE
nA_hE,m,p,a	hEM
nA_hE,m,p,m	hEM
nA_hE,m,p,u	hEM
nA_hE,m,s,a	hE
nA_hE,m,s,m	hE
nA_hE,m,s,u	hE

nA_hogA,f,p,a	hoMgI
nA_hogA,f,p,m	hoMgI
nA_hogA,f,p,u	hoMgI
nA_hogA,f,s,a	hogI
nA_hogA,f,s,m	hogI
nA_hogA,f,s,u	hogI
nA_hogA,m,p,a	hoMge
nA_hogA,m,p,m	hoMge
nA_hogA,m,p,u	hoMge
nA_hogA,m,s,a	hogA
nA_hogA,m,s,m	hogA
nA_hogA,m,s,u	hogA

nA_padA,f,p,a	padIM
nA_padA,f,p,m	padIM
nA_padA,f,p,u	padIM
nA_padA,f,s,a	padI
nA_padA,f,s,m	padI
nA_padA,f,s,u	padI
nA_padA,m,p,a	pade
nA_padA,m,p,m	pade
nA_padA,m,p,u	pade
nA_padA,m,s,a	padA
nA_padA,m,s,m	padA
nA_padA,m,s,u	padA

nA_padawA_WA,f,p,a	padawIM_WIM
nA_padawA_WA,f,p,m	padawIM_WIM
nA_padawA_WA,f,p,u	padawIM_WIM
nA_padawA_WA,f,s,a	padawI_WI
nA_padawA_WA,f,s,m	padawI_WI
nA_padawA_WA,f,s,u	padawI_WI
nA_padawA_WA,m,p,a	padawe_We
nA_padawA_WA,m,p,m	padawe_We
nA_padawA_WA,m,p,u	padawe_We
nA_padawA_WA,m,s,a	padawA_WA
nA_padawA_WA,m,s,m	padawA_WA
nA_padawA_WA,m,s,u	padawA_WA

nA_padegA,f,p,a	padeMgI
nA_padegA,f,p,m	padeMgI
nA_padegA,f,p,u	padeMgI
nA_padegA,f,s,a	padegI
nA_padegA,f,s,m	padegI
nA_padegA,f,s,u	padegI
nA_padegA,m,p,a	padeMge
nA_padegA,m,p,m	padeMge
nA_padegA,m,p,u	padeMge
nA_padegA,m,s,a	padegA
nA_padegA,m,s,m	padegA
nA_padegA,m,s,u	padegA

nA_cAhawA_hE,m,s,a	cAhawA_hE
nA_cAhawA_hE,f,s,a	cAhawI_hE
nA_cAhawA_hE,m,p,a	cAhawe_hEM
nA_cAhawA_hE,f,p,a	cAhawI_hEM
nA_cAhawA_hE,m,s,u	cAhawA_hUz
nA_cAhawA_hE,f,s,u	cAhawI_hUz
nA_cAhawA_hE,m,p,u	cAhawe_hEM
nA_cAhawA_hE,f,p,u	cAhawe_hEM
nA_cAhawA_hE,m,s,m	cAhawe_ho
nA_cAhawA_hE,m,p,m	cAhawe_ho
nA_cAhawA_hE,f,s,m	cAhawe_ho
nA_cAhawA_hE,f,p,m	cAhawI_ho

nA_cAhiye,f,p,a	cAhiye
nA_cAhiye,f,p,m	cAhiye
nA_cAhiye,f,p,u	cAhiye
nA_cAhiye,f,s,a	cAhiye
nA_cAhiye,f,s,m	cAhiye
nA_cAhiye,f,s,u	cAhiye
nA_cAhiye,m,p,a	cAhiye
nA_cAhiye,m,p,m	cAhiye
nA_cAhiye,m,p,u	cAhiye
nA_cAhiye,m,s,a	cAhiye
nA_cAhiye,m,s,m	cAhiye
nA_cAhiye,m,s,u	cAhiye

nA_cAhiye_WA,f,p,a	cAhiye_WIM
nA_cAhiye_WA,f,p,m	cAhiye_WIM
nA_cAhiye_WA,f,p,u	cAhiye_WIM
nA_cAhiye_WA,f,s,a	cAhiye_WI
nA_cAhiye_WA,f,s,m	cAhiye_WI
nA_cAhiye_WA,f,s,u	cAhiye_WI
nA_cAhiye_WA,m,p,a	cAhiye_We
nA_cAhiye_WA,m,p,m	cAhiye_We
nA_cAhiye_WA,m,p,u	cAhiye_We
nA_cAhiye_WA,m,s,a	cAhiye_WA
nA_cAhiye_WA,m,s,m	cAhiye_WA
nA_cAhiye_WA,m,s,u	cAhiye_WA

nA_vAlA_hE,m,s,a	vAlA_hE
nA_vAlA_hE,f,s,a	vAlII_hE
nA_vAlA_hE,m,p,a	vAle_hEM
nA_vAlA_hE,f,p,a	vAlI_hEM
nA_vAlA_hE,m,s,u	vAlA_hUz
nA_vAlA_hE,f,s,u	vAlI_huZ
nA_vAlA_hE,m,p,u	vAle_hEM
nA_vAlA_hE,f,p,u	vAle_hEM
nA_vAlA_hE,m,s,m	vAle_ho
nA_vAlA_hE,m,p,m	vAle_ho
nA_vAlA_hE,f,s,m	vAlI_ho
nA_vAlA_hE,f,p,m	vAle_ho

nA_hI_hE,f,p,m	hI_hE
nA_hI_hE,f,p,u	hI_hEM
nA_hI_hE,f,s,a	hI_hE
nA_hI_hE,f,s,m	hI_hE
nA_hI_hE,f,s,u	hI_hE
nA_hI_hE,m,p,a	hI_hEM
nA_hI_hE,m,p,m	hI_hE
nA_hI_hE,m,p,u	hI_hEM
nA_hI_hE,m,s,a	hI_hE
nA_hI_hE,m,s,m	hI_hE
nA_hI_hE,m,s,u	hI_hE

nA_hI_WA,f,p,a	nA_hI_WA
nA_hI_WA,f,p,m	nA_hI_WA
nA_hI_WA,f,p,u	nA_hI_WA
nA_hI_WA,f,s,a	nA_hI_WA
nA_hI_WA,f,s,m	nA_hI_WA
nA_hI_WA,f,s,u	nA_hI_WA
nA_hI_WA,m,p,a	nA_hI_WA
nA_hI_WA,m,p,m	nA_hI_WA
nA_hI_WA,m,p,u	nA_hI_WA
nA_hI_WA,m,s,a	nA_hI_WA
nA_hI_WA,m,s,m	nA_hI_WA
nA_hI_WA,m,s,u	nA_hI_WA

nA_kA_cAhiye_honA,f,p,a	nA_kA_cAhiye_honA
nA_kA_cAhiye_honA,f,p,m	nA_kA_cAhiye_honA
nA_kA_cAhiye_honA,f,p,u	nA_kA_cAhiye_honA
nA_kA_cAhiye_honA,f,s,a	nA_kA_cAhiye_honA
nA_kA_cAhiye_honA,f,s,m	nA_kA_cAhiye_honA
nA_kA_cAhiye_honA,f,s,u	nA_kA_cAhiye_honA
nA_kA_cAhiye_honA,m,p,a	nA_kA_cAhiye_honA
nA_kA_cAhiye_honA,m,p,m	nA_kA_cAhiye_honA
nA_kA_cAhiye_honA,m,p,u	nA_kA_cAhiye_honA
nA_kA_cAhiye_honA,m,s,a	nA_kA_cAhiye_honA
nA_kA_cAhiye_honA,m,s,m	nA_kA_cAhiye_honA
nA_kA_cAhiye_honA,m,s,u	nA_kA_cAhiye_honA

nA_ke_bAxa,f,p,a	nA_ke_bAxa
nA_ke_bAxa,f,p,m	nA_ke_bAxa
nA_ke_bAxa,f,p,u	nA_ke_bAxa
nA_ke_bAxa,f,s,a	nA_ke_bAxa
nA_ke_bAxa,f,s,m	nA_ke_bAxa
nA_ke_bAxa,f,s,u	nA_ke_bAxa
nA_ke_bAxa,m,p,a	nA_ke_bAxa
nA_ke_bAxa,m,p,m	nA_ke_bAxa
nA_ke_bAxa,m,p,u	nA_ke_bAxa
nA_ke_bAxa,m,s,a	nA_ke_bAxa
nA_ke_bAxa,m,s,m	nA_ke_bAxa
nA_ke_bAxa,m,s,u	nA_ke_bAxa

nA_ke_kAraNa,f,p,a	nA_ke_kAraNa
nA_ke_kAraNa,f,p,m	nA_ke_kAraNa
nA_ke_kAraNa,f,p,u	nA_ke_kAraNa
nA_ke_kAraNa,f,s,a	nA_ke_kAraNa
nA_ke_kAraNa,f,s,m	nA_ke_kAraNa
nA_ke_kAraNa,f,s,u	nA_ke_kAraNa
nA_ke_kAraNa,m,p,a	nA_ke_kAraNa
nA_ke_kAraNa,m,p,m	nA_ke_kAraNa
nA_ke_kAraNa,m,p,u	nA_ke_kAraNa
nA_ke_kAraNa,m,s,a	nA_ke_kAraNa
nA_ke_kAraNa,m,s,m	nA_ke_kAraNa
nA_ke_kAraNa,m,s,u	nA_ke_kAraNa

nA_kI_himmawa_hE,f,p,a	nA_kI_himmawa_hE
nA_kI_himmawa_hE,f,p,m	nA_kI_himmawa_hE
nA_kI_himmawa_hE,f,p,u	nA_kI_himmawa_hE
nA_kI_himmawa_hE,f,s,a	nA_kI_himmawa_hE
nA_kI_himmawa_hE,f,s,m	nA_kI_himmawa_hE
nA_kI_himmawa_hE,f,s,u	nA_kI_himmawa_hE
nA_kI_himmawa_hE,m,p,a	nA_kI_himmawa_hE
nA_kI_himmawa_hE,m,p,m	nA_kI_himmawa_hE
nA_kI_himmawa_hE,m,p,u	nA_kI_himmawa_hE
nA_kI_himmawa_hE,m,s,a	nA_kI_himmawa_hE
nA_kI_himmawa_hE,m,s,m	nA_kI_himmawa_hE
nA_kI_himmawa_hE,m,s,u	nA_kI_himmawa_hE

nA_kI_himmawa_WI,f,p,a	nA_kI_himmawa_WI
nA_kI_himmawa_WI,f,p,m	nA_kI_himmawa_WI
nA_kI_himmawa_WI,f,p,u	nA_kI_himmawa_WI
nA_kI_himmawa_WI,f,s,a	nA_kI_himmawa_WI
nA_kI_himmawa_WI,f,s,m	nA_kI_himmawa_WI
nA_kI_himmawa_WI,f,s,u	nA_kI_himmawa_WI
nA_kI_himmawa_WI,m,p,a	nA_kI_himmawa_WI
nA_kI_himmawa_WI,m,p,m	nA_kI_himmawa_WI
nA_kI_himmawa_WI,m,p,u	nA_kI_himmawa_WI
nA_kI_himmawa_WI,m,s,a	nA_kI_himmawa_WI
nA_kI_himmawa_WI,m,s,m	nA_kI_himmawa_WI
nA_kI_himmawa_WI,m,s,u	nA_kI_himmawa_WI

nA_kI_jarUrawa_hE,m,s,a	kI_jarUrawa_hE
nA_kI_jarUrawa_hE,f,s,a	kI_jarUrawa_hE
nA_kI_jarUrawa_hE,m,p,a	kI_jarUrawa_hE
nA_kI_jarUrawa_hE,f,p,a	kI_jarUrawa_hE
nA_kI_jarUrawa_hE,m,s,u	kI_jarUrawa_hE
nA_kI_jarUrawa_hE,f,s,u	kI_jarUrawa_hE
nA_kI_jarUrawa_hE,m,p,u	kI_jarUrawa_hE
nA_kI_jarUrawa_hE,f,p,u	kI_jarUrawa_hE
nA_kI_jarUrawa_hE,m,s,m	kI_jarUrawa_hE
nA_kI_jarUrawa_hE,m,p,m	kI_jarUrawa_hE
nA_kI_jarUrawa_hE,f,s,m	kI_jarUrawa_hE
nA_kI_jarUrawa_hE,f,p,m	kI_jarUrawa_hE

nA_kI_jarUrawa_nahIM_hE,m,s,a	kI_jarUrawa_nahIM_hE
nA_kI_jarUrawa_nahIM_hE,f,s,a	kI_jarUrawa_nahIM_hE
nA_kI_jarUrawa_nahIM_hE,m,p,a	kI_jarUrawa_nahIM_hE
nA_kI_jarUrawa_nahIM_hE,f,p,a	kI_jarUrawa_nahIM_hE
nA_kI_jarUrawa_nahIM_hE,m,s,u	kI_jarUrawa_nahIM_hE
nA_kI_jarUrawa_nahIM_hE,f,s,u	kI_jarUrawa_nahIM_hE
nA_kI_jarUrawa_nahIM_hE,m,p,u	kI_jarUrawa_nahIM_hE
nA_kI_jarUrawa_nahIM_hE,f,p,u	kI_jarUrawa_nahIM_hE
nA_kI_jarUrawa_nahIM_hE,m,s,m	kI_jarUrawa_nahIM_hE
nA_kI_jarUrawa_nahIM_hE,m,p,m	kI_jarUrawa_nahIM_hE
nA_kI_jarUrawa_nahIM_hE,f,s,m	kI_jarUrawa_nahIM_hE
nA_kI_jarUrawa_nahIM_hE,f,p,m	kI_jarUrawa_nahIM_hE

nA_kI_jZarUrawa_hogI,f,p,a	nA_kI_jZarUrawa_hogI
nA_kI_jZarUrawa_hogI,f,p,m	nA_kI_jZarUrawa_hogI
nA_kI_jZarUrawa_hogI,f,p,u	nA_kI_jZarUrawa_hogI
nA_kI_jZarUrawa_hogI,f,s,a	nA_kI_jZarUrawa_hogI
nA_kI_jZarUrawa_hogI,f,s,m	nA_kI_jZarUrawa_hogI
nA_kI_jZarUrawa_hogI,f,s,u	nA_kI_jZarUrawa_hogI
nA_kI_jZarUrawa_hogI,m,p,a	nA_kI_jZarUrawa_hogI
nA_kI_jZarUrawa_hogI,m,p,m	nA_kI_jZarUrawa_hogI
nA_kI_jZarUrawa_hogI,m,p,u	nA_kI_jZarUrawa_hogI
nA_kI_jZarUrawa_hogI,m,s,a	nA_kI_jZarUrawa_hogI
nA_kI_jZarUrawa_hogI,m,s,m	nA_kI_jZarUrawa_hogI
nA_kI_jZarUrawa_hogI,m,s,u	nA_kI_jZarUrawa_hogI

nA_pasanxa_kara_gA,f,p,a	nA_pasanxa_kara_gA
nA_pasanxa_kara_gA,f,p,m	nA_pasanxa_kara_gA
nA_pasanxa_kara_gA,f,p,u	nA_pasanxa_kara_gA
nA_pasanxa_kara_gA,f,s,a	nA_pasanxa_kara_gA
nA_pasanxa_kara_gA,f,s,m	nA_pasanxa_kara_gA
nA_pasanxa_kara_gA,f,s,u	nA_pasanxa_kara_gA
nA_pasanxa_kara_gA,m,p,a	nA_pasanxa_kara_gA
nA_pasanxa_kara_gA,m,p,m	nA_pasanxa_kara_gA
nA_pasanxa_kara_gA,m,p,u	nA_pasanxa_kara_gA
nA_pasanxa_kara_gA,m,s,a	nA_pasanxa_kara_gA
nA_pasanxa_kara_gA,m,s,m	nA_pasanxa_kara_gA
nA_pasanxa_kara_gA,m,s,u	nA_pasanxa_kara_gA

nA_pasanxa_karawA_hE,f,p,a	nA_pasanxa_karawA_hE
nA_pasanxa_karawA_hE,f,p,m	nA_pasanxa_karawA_hE
nA_pasanxa_karawA_hE,f,p,u	nA_pasanxa_karawA_hE
nA_pasanxa_karawA_hE,f,s,a	nA_pasanxa_karawA_hE
nA_pasanxa_karawA_hE,f,s,m	nA_pasanxa_karawA_hE
nA_pasanxa_karawA_hE,f,s,u	nA_pasanxa_karawA_hE
nA_pasanxa_karawA_hE,m,p,a	nA_pasanxa_karawA_hE
nA_pasanxa_karawA_hE,m,p,m	nA_pasanxa_karawA_hE
nA_pasanxa_karawA_hE,m,p,u	nA_pasanxa_karawA_hE
nA_pasanxa_karawA_hE,m,s,a	nA_pasanxa_karawA_hE
nA_pasanxa_karawA_hE,m,s,m	nA_pasanxa_karawA_hE
nA_pasanxa_karawA_hE,m,s,u	nA_pasanxa_karawA_hE

nA_pasanxa_nahIM_karawA_hE,f,p,a	nA_pasanxa_nahIM_karawA_hE
nA_pasanxa_nahIM_karawA_hE,f,p,m	nA_pasanxa_nahIM_karawA_hE
nA_pasanxa_nahIM_karawA_hE,f,p,u	nA_pasanxa_nahIM_karawA_hE
nA_pasanxa_nahIM_karawA_hE,f,s,a	nA_pasanxa_nahIM_karawA_hE
nA_pasanxa_nahIM_karawA_hE,f,s,m	nA_pasanxa_nahIM_karawA_hE
nA_pasanxa_nahIM_karawA_hE,f,s,u	nA_pasanxa_nahIM_karawA_hE
nA_pasanxa_nahIM_karawA_hE,m,p,a	nA_pasanxa_nahIM_karawA_hE
nA_pasanxa_nahIM_karawA_hE,m,p,m	nA_pasanxa_nahIM_karawA_hE
nA_pasanxa_nahIM_karawA_hE,m,p,u	nA_pasanxa_nahIM_karawA_hE
nA_pasanxa_nahIM_karawA_hE,m,s,a	nA_pasanxa_nahIM_karawA_hE
nA_pasanxa_nahIM_karawA_hE,m,s,m	nA_pasanxa_nahIM_karawA_hE
nA_pasanxa_nahIM_karawA_hE,m,s,u	nA_pasanxa_nahIM_karawA_hE

nA_pasanxa_karawA_WA,f,p,a	nA_pasanxa_karawA_WA
nA_pasanxa_karawA_WA,f,p,m	nA_pasanxa_karawA_WA
nA_pasanxa_karawA_WA,f,p,u	nA_pasanxa_karawA_WA
nA_pasanxa_karawA_WA,f,s,a	nA_pasanxa_karawA_WA
nA_pasanxa_karawA_WA,f,s,m	nA_pasanxa_karawA_WA
nA_pasanxa_karawA_WA,f,s,u	nA_pasanxa_karawA_WA
nA_pasanxa_karawA_WA,m,p,a	nA_pasanxa_karawA_WA
nA_pasanxa_karawA_WA,m,p,m	nA_pasanxa_karawA_WA
nA_pasanxa_karawA_WA,m,p,u	nA_pasanxa_karawA_WA
nA_pasanxa_karawA_WA,m,s,a	nA_pasanxa_karawA_WA
nA_pasanxa_karawA_WA,m,s,m	nA_pasanxa_karawA_WA
nA_pasanxa_karawA_WA,m,s,u	nA_pasanxa_karawA_WA

nA_pasanxa_nahIM_karawA_WA,f,p,a	nA_pasanxa_nahIM_karawA_WA
nA_pasanxa_nahIM_karawA_WA,f,p,m	nA_pasanxa_nahIM_karawA_WA
nA_pasanxa_nahIM_karawA_WA,f,p,u	nA_pasanxa_nahIM_karawA_WA
nA_pasanxa_nahIM_karawA_WA,f,s,a	nA_pasanxa_nahIM_karawA_WA
nA_pasanxa_nahIM_karawA_WA,f,s,m	nA_pasanxa_nahIM_karawA_WA
nA_pasanxa_nahIM_karawA_WA,f,s,u	nA_pasanxa_nahIM_karawA_WA
nA_pasanxa_nahIM_karawA_WA,m,p,a	nA_pasanxa_nahIM_karawA_WA
nA_pasanxa_nahIM_karawA_WA,m,p,m	nA_pasanxa_nahIM_karawA_WA
nA_pasanxa_nahIM_karawA_WA,m,p,u	nA_pasanxa_nahIM_karawA_WA
nA_pasanxa_nahIM_karawA_WA,m,s,a	nA_pasanxa_nahIM_karawA_WA
nA_pasanxa_nahIM_karawA_WA,m,s,m	nA_pasanxa_nahIM_karawA_WA
nA_pasanxa_nahIM_karawA_WA,m,s,u	nA_pasanxa_nahIM_karawA_WA

nA_unako_xo,f,p,a	nA_unako_xo
nA_unako_xo,f,p,m	nA_unako_xo
nA_unako_xo,f,p,u	nA_unako_xo
nA_unako_xo,f,s,a	nA_unako_xo
nA_unako_xo,f,s,m	nA_unako_xo
nA_unako_xo,f,s,u	nA_unako_xo
nA_unako_xo,m,p,a	nA_unako_xo
nA_unako_xo,m,p,m	nA_unako_xo
nA_unako_xo,m,p,u	nA_unako_xo
nA_unako_xo,m,s,a	nA_unako_xo
nA_unako_xo,m,s,m	nA_unako_xo
nA_unako_xo,m,s,u	nA_unako_xo

nA_usako_xo,f,p,a	nA_usako
nA_usako_xo,f,p,m	nA_usako
nA_usako_xo,f,p,u	nA_usako
nA_usako_xo,f,s,a	nA_usako
nA_usako_xo,f,s,m	nA_usako
nA_usako_xo,f,s,u	nA_usako
nA_usako_xo,m,p,a	nA_usako
nA_usako_xo,m,p,m	nA_usako
nA_usako_xo,m,p,u	nA_usako
nA_usako_xo,m,s,a	nA_usako
nA_usako_xo,m,s,m	nA_usako
nA_usako_xo,m,s,u	nA_usako

nA1_padegA,f,p,a	nA1_padegA
nA1_padegA,f,p,m	nA1_padegA
nA1_padegA,f,p,u	nA1_padegA
nA1_padegA,f,s,a	nA1_padegA
nA1_padegA,f,s,m	nA1_padegA
nA1_padegA,f,s,u	nA1_padegA
nA1_padegA,m,p,a	nA1_padegA
nA1_padegA,m,p,m	nA1_padegA
nA1_padegA,m,p,u	nA1_padegA
nA1_padegA,m,s,a	nA1_padegA
nA1_padegA,m,s,m	nA1_padegA
nA1_padegA,m,s,u	nA1_padegA

nA1_padegA_WA,f,p,a	nA1_padegA_WA
nA1_padegA_WA,f,p,m	nA1_padegA_WA
nA1_padegA_WA,f,p,u	nA1_padegA_WA
nA1_padegA_WA,f,s,a	nA1_padegA_WA
nA1_padegA_WA,f,s,m	nA1_padegA_WA
nA1_padegA_WA,f,s,u	nA1_padegA_WA
nA1_padegA_WA,m,p,a	nA1_padegA_WA
nA1_padegA_WA,m,p,m	nA1_padegA_WA
nA1_padegA_WA,m,p,u	nA1_padegA_WA
nA1_padegA_WA,m,s,a	nA1_padegA_WA
nA1_padegA_WA,m,s,m	nA1_padegA_WA
nA1_padegA_WA,m,s,u	nA1_padegA_WA

nA2_padegA,f,p,a	nA2_padegA
nA2_padegA,f,p,m	nA2_padegA
nA2_padegA,f,p,u	nA2_padegA
nA2_padegA,f,s,a	nA2_padegA
nA2_padegA,f,s,m	nA2_padegA
nA2_padegA,f,s,u	nA2_padegA
nA2_padegA,m,p,a	nA2_padegA
nA2_padegA,m,p,m	nA2_padegA
nA2_padegA,m,p,u	nA2_padegA
nA2_padegA,m,s,a	nA2_padegA
nA2_padegA,m,s,m	nA2_padegA
nA2_padegA,m,s,u	nA2_padegA

ne_kA_niScaya_kiyA,m,s,a	kA_niScaya_kiyA
ne_kA_niScaya_kiyA,f,s,a	kI_niScaya_kI
ne_kA_niScaya_kiyA,m,p,a	kA_niScaya_kiye
ne_kA_niScaya_kiyA,f,p,a	kI_niScaya_kI
ne_kA_niScaya_kiyA,m,s,u	kA_niScaya_kiyA
ne_kA_niScaya_kiyA,f,s,u	kI_niScaya_kI
ne_kA_niScaya_kiyA,m,p,u	kA_niScaya_kiye
ne_kA_niScaya_kiyA,f,p,u	kI_niScaya_kI
ne_kA_niScaya_kiyA,m,s,m	kA_niScaya_kiye
ne_kA_niScaya_kiyA,m,p,m	kA_niScaya_kiye
ne_kA_niScaya_kiyA,f,s,m	kI_niScaya_kI
ne_kA_niScaya_kiyA,f,p,m	kI_niScaya_kiye

ne_ke_bAxa,f,p,a	ke_bAxa
ne_ke_bAxa,f,p,m	ke_bAxa
ne_ke_bAxa,f,p,u	ke_bAxa
ne_ke_bAxa,f,s,a	ke_bAxa
ne_ke_bAxa,f,s,m	ke_bAxa
ne_ke_bAxa,f,s,u	ke_bAxa
ne_ke_bAxa,m,p,a	ke_bAxa
ne_ke_bAxa,m,p,m	ke_bAxa
ne_ke_bAxa,m,p,u	ke_bAxa
ne_ke_bAxa,m,s,a	ke_bAxa
ne_ke_bAxa,m,s,m	ke_bAxa
ne_ke_bAxa,m,s,u	ke_bAxa

ne_ke_bIca,f,p,a	ke_bIca
ne_ke_bIca,f,p,m	ke_bIca
ne_ke_bIca,f,p,u	ke_bIca
ne_ke_bIca,f,s,a	ke_bIca
ne_ke_bIca,f,s,m	ke_bIca
ne_ke_bIca,f,s,u	ke_bIca
ne_ke_bIca,m,p,a	ke_bIca
ne_ke_bIca,m,p,m	ke_bIca
ne_ke_bIca,m,p,u	ke_bIca
ne_ke_bIca,m,s,a	ke_bIca
ne_ke_bIca,m,s,m	ke_bIca
ne_ke_bIca,m,s,u	ke_bIca

ne_ke_liye,f,p,a	ke_liye
ne_ke_liye,f,p,m	ke_liye
ne_ke_liye,f,p,u	ke_liye
ne_ke_liye,f,s,a	ke_liye
ne_ke_liye,f,s,m	ke_liye
ne_ke_liye,f,s,u	ke_liye
ne_ke_liye,m,p,a	ke_liye
ne_ke_liye,m,p,m	ke_liye
ne_ke_liye,m,p,u	ke_liye
ne_ke_liye,m,s,a	ke_liye
ne_ke_liye,m,s,m	ke_liye
ne_ke_liye,m,s,u	ke_liye

ne_ke_pahale,f,p,a	ke_pahale
ne_ke_pahale,f,p,m	ke_pahale
ne_ke_pahale,f,p,u	ke_pahale
ne_ke_pahale,f,s,a	ke_pahale
ne_ke_pahale,f,s,m	ke_pahale
ne_ke_pahale,f,s,u	ke_pahale
ne_ke_pahale,m,p,a	ke_pahale
ne_ke_pahale,m,p,m	ke_pahale
ne_ke_pahale,m,p,u	ke_pahale
ne_ke_pahale,m,s,a	ke_pahale
ne_ke_pahale,m,s,m	ke_pahale
ne_ke_pahale,m,s,u	ke_pahale

ne_ke_pare,f,p,a	ke_pare
ne_ke_pare,f,p,m	ke_pare
ne_ke_pare,f,p,u	ke_pare
ne_ke_pare,f,s,a	ke_pare
ne_ke_pare,f,s,m	ke_pare
ne_ke_pare,f,s,u	ke_pare
ne_ke_pare,m,p,a	ke_pare
ne_ke_pare,m,p,m	ke_pare
ne_ke_pare,m,p,u	ke_pare
ne_ke_pare,m,s,a	ke_pare
ne_ke_pare,m,s,m	ke_pare
ne_ke_pare,m,s,u	ke_pare

ne_ke_viruxXa,f,p,a	ke_viruxXa
ne_ke_viruxXa,f,p,m	ke_viruxXa
ne_ke_viruxXa,f,p,u	ke_viruxXa
ne_ke_viruxXa,f,s,a	ke_viruxXa
ne_ke_viruxXa,f,s,m	ke_viruxXa
ne_ke_viruxXa,f,s,u	ke_viruxXa
ne_ke_viruxXa,m,p,a	ke_viruxXa
ne_ke_viruxXa,m,p,m	ke_viruxXa
ne_ke_viruxXa,m,p,u	ke_viruxXa
ne_ke_viruxXa,m,s,a	ke_viruxXa
ne_ke_viruxXa,m,s,m	ke_viruxXa
ne_ke_viruxXa,m,s,u	ke_viruxXa

ne_ke_bAre_meM,f,p,a	ke_bAre_meM
ne_ke_bAre_meM,f,p,m	ke_bAre_meM
ne_ke_bAre_meM,f,p,u	ke_bAre_meM
ne_ke_bAre_meM,f,s,a	ke_bAre_meM
ne_ke_bAre_meM,f,s,m	ke_bAre_meM
ne_ke_bAre_meM,f,s,u	ke_bAre_meM
ne_ke_bAre_meM,m,p,a	ke_bAre_meM
ne_ke_bAre_meM,m,p,m	ke_bAre_meM
ne_ke_bAre_meM,m,p,u	ke_bAre_meM
ne_ke_bAre_meM,m,s,a	ke_bAre_meM
ne_ke_bAre_meM,m,s,m	ke_bAre_meM
ne_ke_bAre_meM,m,s,u	ke_bAre_meM

ne_kI_jarUrawa_hE,f,p,a	kI_jarUrawa_hE
ne_kI_jarUrawa_hE,f,p,m	kI_jarUrawa_hE
ne_kI_jarUrawa_hE,f,p,u	kI_jarUrawa_hE
ne_kI_jarUrawa_hE,f,s,a	kI_jarUrawa_hE
ne_kI_jarUrawa_hE,f,s,m	kI_jarUrawa_hE
ne_kI_jarUrawa_hE,f,s,u	kI_jarUrawa_hE
ne_kI_jarUrawa_hE,m,p,a	kI_jarUrawa_hE
ne_kI_jarUrawa_hE,m,p,m	kI_jarUrawa_hE
ne_kI_jarUrawa_hE,m,p,u	kI_jarUrawa_hE
ne_kI_jarUrawa_hE,m,s,a	kI_jarUrawa_hE
ne_kI_jarUrawa_hE,m,s,m	kI_jarUrawa_hE
ne_kI_jarUrawa_hE,m,s,u	kI_jarUrawa_hE

ne_kI_jarUrawa_nahIM_hE,f,p,a	kI_jarUrawa_nahIM_hE
ne_kI_jarUrawa_nahIM_hE,f,p,m	kI_jarUrawa_nahIM_hE
ne_kI_jarUrawa_nahIM_hE,f,p,u	kI_jarUrawa_nahIM_hE
ne_kI_jarUrawa_nahIM_hE,f,s,a	kI_jarUrawa_nahIM_hE
ne_kI_jarUrawa_nahIM_hE,f,s,m	kI_jarUrawa_nahIM_hE
ne_kI_jarUrawa_nahIM_hE,f,s,u	kI_jarUrawa_nahIM_hE
ne_kI_jarUrawa_nahIM_hE,m,p,a	kI_jarUrawa_nahIM_hE
ne_kI_jarUrawa_nahIM_hE,m,p,m	kI_jarUrawa_nahIM_hE
ne_kI_jarUrawa_nahIM_hE,m,p,u	kI_jarUrawa_nahIM_hE
ne_kI_jarUrawa_nahIM_hE,m,s,a	kI_jarUrawa_nahIM_hE
ne_kI_jarUrawa_nahIM_hE,m,s,m	kI_jarUrawa_nahIM_hE
ne_kI_jarUrawa_nahIM_hE,m,s,u	kI_jarUrawa_nahIM_hE

ne_kI_jarUrawa_pada_sakawI_hE,f,p,a	kI_jarUrawa_pada_sakawI_hE
ne_kI_jarUrawa_pada_sakawI_hE,f,p,m	kI_jarUrawa_pada_sakawI_hE
ne_kI_jarUrawa_pada_sakawI_hE,f,p,u	kI_jarUrawa_pada_sakawI_hE
ne_kI_jarUrawa_pada_sakawI_hE,f,s,a	kI_jarUrawa_pada_sakawI_hE
ne_kI_jarUrawa_pada_sakawI_hE,f,s,m	kI_jarUrawa_pada_sakawI_hE
ne_kI_jarUrawa_pada_sakawI_hE,f,s,u	kI_jarUrawa_pada_sakawI_hE
ne_kI_jarUrawa_pada_sakawI_hE,m,p,a	kI_jarUrawa_pada_sakawI_hE
ne_kI_jarUrawa_pada_sakawI_hE,m,p,m	kI_jarUrawa_pada_sakawI_hE
ne_kI_jarUrawa_pada_sakawI_hE,m,p,u	kI_jarUrawa_pada_sakawI_hE
ne_kI_jarUrawa_pada_sakawI_hE,m,s,a	kI_jarUrawa_pada_sakawI_hE
ne_kI_jarUrawa_pada_sakawI_hE,m,s,m	kI_jarUrawa_pada_sakawI_hE
ne_kI_jarUrawa_pada_sakawI_hE,m,s,u	kI_jarUrawa_pada_sakawI_hE

ne_kI_sWiwi_meM_ho,m,s,a	kI_sWiwi_meM_hE
ne_kI_sWiwi_meM_ho,f,s,a	kI_sWiwi_meM_hE
ne_kI_sWiwi_meM_ho,m,p,a	kI_sWiwi_meM_hEM
ne_kI_sWiwi_meM_ho,f,p,a	kI_sWiwi_meM_hEM
ne_kI_sWiwi_meM_ho,m,s,u	kI_sWiwi_meM_hUz
ne_kI_sWiwi_meM_ho,f,s,u	kI_sWiwi_meM_hUz
ne_kI_sWiwi_meM_ho,m,p,u	kI_sWiwi_meM_hEM
ne_kI_sWiwi_meM_ho,f,p,u	kI_sWiwi_meM_hEM
ne_kI_sWiwi_meM_ho,m,s,m	kI_sWiwi_meM_ho
ne_kI_sWiwi_meM_ho,m,p,m	kI_sWiwi_meM_ho
ne_kI_sWiwi_meM_ho,f,s,m	kI_sWiwi_meM_ho
ne_kI_sWiwi_meM_ho,f,p,m	kI_sWiwi_meM_ho

ne_meM,f,p,a	meM
ne_meM,f,p,m	meM
ne_meM,f,p,u	meM
ne_meM,f,s,a	meM
ne_meM,f,s,m	meM
ne_meM,f,s,u	meM
ne_meM,m,p,a	meM
ne_meM,m,p,m	meM
ne_meM,m,p,u	meM
ne_meM,m,s,a	meM
ne_meM,m,s,m	meM
ne_meM,m,s,u	meM

ne_para,f,p,a	para
ne_para,f,p,m	para
ne_para,f,p,u	para
ne_para,f,s,a	para
ne_para,f,s,m	para
ne_para,f,s,u	para
ne_para,m,p,a	para
ne_para,m,p,m	para
ne_para,m,p,u	para
ne_para,m,s,a	para
ne_para,m,s,m	para
ne_para,m,s,u	para

ne_se,f,p,a	se
ne_se,f,p,m	se
ne_se,f,p,u	se
ne_se,f,s,a	se
ne_se,f,s,m	se
ne_se,f,s,u	se
ne_se,m,p,a	se
ne_se,m,p,m	se
ne_se,m,p,u	se
ne_se,m,s,a	se
ne_se,m,s,m	se
ne_se,m,s,u	se

ne_vAlA_hE,f,p,a	vAlA_hE
ne_vAlA_hE,f,p,m	vAlA_hE
ne_vAlA_hE,f,p,u	vAlA_hE
ne_vAlA_hE,f,s,a	vAlA_hE
ne_vAlA_hE,f,s,m	vAlA_hE
ne_vAlA_hE,f,s,u	vAlA_hE
ne_vAlA_hE,m,p,a	vAlA_hE
ne_vAlA_hE,m,p,m	vAlA_hE
ne_vAlA_hE,m,p,u	vAlA_hE
ne_vAlA_hE,m,s,a	vAlA_hE
ne_vAlA_hE,m,s,m	vAlA_hE
ne_vAlA_hE,m,s,u	vAlA_hE

ne_vAlA_WA,f,p,a	vAlA_WA
ne_vAlA_WA,f,p,m	vAlA_WA
ne_vAlA_WA,f,p,u	vAlA_WA
ne_vAlA_WA,f,s,a	vAlA_WA
ne_vAlA_WA,f,s,m	vAlA_WA
ne_vAlA_WA,f,s,u	vAlA_WA
ne_vAlA_WA,m,p,a	vAlA_WA
ne_vAlA_WA,m,p,m	vAlA_WA
ne_vAlA_WA,m,p,u	vAlA_WA
ne_vAlA_WA,m,s,a	vAlA_WA
ne_vAlA_WA,m,s,m	vAlA_WA
ne_vAlA_WA,m,s,u	vAlA_WA

ne_xiyA_jAye,f,p,a	xiyA_jAye
ne_xiyA_jAye,f,p,m	xiyA_jAye
ne_xiyA_jAye,f,p,u	xiyA_jAye
ne_xiyA_jAye,f,s,a	xiyA_jAye
ne_xiyA_jAye,f,s,m	xiyA_jAye
ne_xiyA_jAye,f,s,u	xiyA_jAye
ne_xiyA_jAye,m,p,a	xiyA_jAye
ne_xiyA_jAye,m,p,m	xiyA_jAye
ne_xiyA_jAye,m,p,u	xiyA_jAye
ne_xiyA_jAye,m,s,a	xiyA_jAye
ne_xiyA_jAye,m,s,m	xiyA_jAye
ne_xiyA_jAye,m,s,u	xiyA_jAye

ne_xo,m,s,a	xo
ne_xo,f,s,a	xo
ne_xo,m,p,a	xo
ne_xo,f,p,a	xo
ne_xo,m,s,u	xo
ne_xo,f,s,u	xo
ne_xo,m,p,u	xo
ne_xo,f,p,u	xo
ne_xo,m,s,m	xo
ne_xo,m,p,m	xo
ne_xo,f,s,m	xo
ne_xo,f,p,m	xo

raha_sakA,f,p,a	raha_sakA
raha_sakA,f,p,m	raha_sakA
raha_sakA,f,p,u	raha_sakA
raha_sakA,f,s,a	raha_sakA
raha_sakA,f,s,m	raha_sakA
raha_sakA,f,s,u	raha_sakA
raha_sakA,m,p,a	raha_sakA
raha_sakA,m,p,m	raha_sakA
raha_sakA,m,p,u	raha_sakA
raha_sakA,m,s,a	raha_sakA
raha_sakA,m,s,m	raha_sakA
raha_sakA,m,s,u	raha_sakA

raha_sakawA,f,p,a	raha_sakawA
raha_sakawA,f,p,m	raha_sakawA
raha_sakawA,f,p,u	raha_sakawA
raha_sakawA,f,s,a	raha_sakawA
raha_sakawA,f,s,m	raha_sakawA
raha_sakawA,f,s,u	raha_sakawA
raha_sakawA,m,p,a	raha_sakawA
raha_sakawA,m,p,m	raha_sakawA
raha_sakawA,m,p,u	raha_sakawA
raha_sakawA,m,s,a	raha_sakawA
raha_sakawA,m,s,m	raha_sakawA
raha_sakawA,m,s,u	raha_sakawA

subj,f,p,a	KAyeM
subj,f,p,m	KAo
subj,f,p,u	KAyeM
subj,f,s,a	KAye
subj,f,s,m	KAye
subj,f,s,u	KAUz
subj,m,p,a	KAyeM
subj,m,p,m	KAo
subj,m,p,u	KAyeM
subj,m,s,a	KAye
subj,m,s,m	KAye
subj,m,s,u	KAUz

wA_hE,f,p,a	hEM
wA_hE,f,p,m	ho
wA_hE,f,p,u	hEM
wA_hE,f,s,a	hE
wA_hE,f,s,m	hE
wA_hE,f,s,u	hUz
wA_hE,m,p,a	hEM
wA_hE,m,p,m	ho
wA_hE,m,p,u	hEM
wA_hE,m,s,a	hE
wA_hE,m,s,m	hE
wA_hE,m,s,u	hUz

wA_ho,f,p,a	ho
wA_ho,f,p,m	ho
wA_ho,f,p,u	ho
wA_ho,f,s,a	ho
wA_ho,f,s,m	ho
wA_ho,f,s,u	ho
wA_ho,m,p,a	ho
wA_ho,m,p,m	ho
wA_ho,m,p,u	ho
wA_ho,m,s,a	ho
wA_ho,m,s,m	ho
wA_ho,m,s,u	ho

wA_huA,f,p,a	huIM
wA_huA,f,p,m	huIM
wA_huA,f,p,u	huIM
wA_huA,f,s,a	huI
wA_huA,f,s,m	huI
wA_huA,f,s,u	huI
wA_huA,m,p,a	hue
wA_huA,m,p,m	hue
wA_huA,m,p,u	hue
wA_huA,m,s,a	huA
wA_huA,m,s,m	huA
wA_huA,m,s,u	huA

wA_WA,m,s,a	WA
wA_WA,f,s,a	WI
wA_WA,m,p,a	We
wA_WA,f,p,a	We
wA_WA,m,s,u	WA
wA_WA,f,s,u	WI
wA_WA,m,p,u	We
wA_WA,f,p,u	We
wA_WA,m,s,m	We
wA_WA,m,p,m	We
wA_WA,f,s,m	WI
wA_WA,f,p,m	WI

wA_hUz_mEM_lAie,f,p,a	wA_hUz_mEM_lAie
wA_hUz_mEM_lAie,f,p,m	wA_hUz_mEM_lAie
wA_hUz_mEM_lAie,f,p,u	wA_hUz_mEM_lAie
wA_hUz_mEM_lAie,f,s,a	wA_hUz_mEM_lAie
wA_hUz_mEM_lAie,f,s,m	wA_hUz_mEM_lAie
wA_hUz_mEM_lAie,f,s,u	wA_hUz_mEM_lAie
wA_hUz_mEM_lAie,m,p,a	wA_hUz_mEM_lAie
wA_hUz_mEM_lAie,m,p,m	wA_hUz_mEM_lAie
wA_hUz_mEM_lAie,m,p,u	wA_hUz_mEM_lAie
wA_hUz_mEM_lAie,m,s,a	wA_hUz_mEM_lAie
wA_hUz_mEM_lAie,m,s,m	wA_hUz_mEM_lAie
wA_hUz_mEM_lAie,m,s,u	wA_hUz_mEM_lAie

wA_rahUzgA,f,p,a	raheMgI
wA_rahUzgA,f,p,m	raheMgI
wA_rahUzgA,f,p,u	raheMgI
wA_rahUzgA,f,s,a	rahegI
wA_rahUzgA,f,s,m	rahegI
wA_rahUzgA,f,s,u	rahUMgI
wA_rahUzgA,m,p,a	raheMge
wA_rahUzgA,m,p,m	raheMge
wA_rahUzgA,m,p,u	raheMge
wA_rahUzgA,m,s,a	rahegA
wA_rahUzgA,m,s,m	rahegA
wA_rahUzgA,m,s,u	rahUMgA

wA_rahegA,f,p,a	raheMgI
wA_rahegA,f,p,m	rahogI
wA_rahegA,f,p,u	raheMgI
wA_rahegA,f,s,a	rahegI
wA_rahegA,f,s,m	rahegI
wA_rahegA,f,s,u	rahUzgI
wA_rahegA,m,p,a	raheMge
wA_rahegA,m,p,m	rahoge
wA_rahegA,m,p,u	raheMge
wA_rahegA,m,s,a	rahegA
wA_rahegA,m,s,m	rahegA
wA_rahegA,m,s,u	rahUzgA

wA_rahA,f,p,a	rahIM
wA_rahA,f,p,m	rahIM
wA_rahA,f,p,u	rahIM
wA_rahA,f,s,a	rahI
wA_rahA,f,s,m	rahI
wA_rahA,f,s,u	rahI
wA_rahA,m,p,a	rahe
wA_rahA,m,p,m	rahe
wA_rahA,m,p,u	rahe
wA_rahA,m,s,a	rahA
wA_rahA,m,s,m	rahA
wA_rahA,m,s,u	rahA

wA_rahA_hE,f,p,a	rahIM_hEM
wA_rahA_hE,f,p,m	rahIM_ho
wA_rahA_hE,f,p,u	rahIM_hEM
wA_rahA_hE,f,s,a	rahI_hE
wA_rahA_hE,f,s,m	rahI_hE
wA_rahA_hE,f,s,u	rahI_hUz
wA_rahA_hE,m,p,a	rahe_hEM
wA_rahA_hE,m,p,m	rahe_ho
wA_rahA_hE,m,p,u	rahe_hEM
wA_rahA_hE,m,s,a	rahA_hE
wA_rahA_hE,m,s,m	rahA_hE
wA_rahA_hE,m,s,u	rahA_hUz

wA_rahA_ho,f,p,a	rahIM_ho
wA_rahA_ho,f,p,m	rahIM_ho
wA_rahA_ho,f,p,u	rahIM_ho
wA_rahA_ho,f,s,a	rahI_ho
wA_rahA_ho,f,s,m	rahI_ho
wA_rahA_ho,f,s,u	rahI_ho
wA_rahA_ho,m,p,a	rahe_ho
wA_rahA_ho,m,p,m	rahe_ho
wA_rahA_ho,m,p,u	rahe_ho
wA_rahA_ho,m,s,a	rahA_ho
wA_rahA_ho,m,s,m	rahA_ho
wA_rahA_ho,m,s,u	rahA_ho

wA_rahA_hogA,f,p,a	rahIM_hoMgI
wA_rahA_hogA,f,p,m	rahIM_hoogI
wA_rahA_hogA,f,p,u	rahIM_hoMgI
wA_rahA_hogA,f,s,a	rahI_hogI
wA_rahA_hogA,f,s,m	rahI_hogI
wA_rahA_hogA,f,s,u	rahI_hoUzgI
wA_rahA_hogA,m,p,a	rahe_hoMge
wA_rahA_hogA,m,p,m	rahe_hoge
wA_rahA_hogA,m,p,u	rahe_hoMge
wA_rahA_hogA,m,s,a	rahA_hogA
wA_rahA_hogA,m,s,m	rahA_hogA
wA_rahA_hogA,m,s,u	rahA_hoUzgA

wA_rahA_WA,f,p,a	rahIM_WIM
wA_rahA_WA,f,p,m	rahIM_WIM
wA_rahA_WA,f,p,u	rahIM_WIM
wA_rahA_WA,f,s,a	rahI_WI
wA_rahA_WA,f,s,m	rahI_WI
wA_rahA_WA,f,s,u	rahI_WI
wA_rahA_WA,m,p,a	rahe_We
wA_rahA_WA,m,p,m	rahe_We
wA_rahA_WA,m,p,u	rahe_We
wA_rahA_WA,m,s,a	rahA_WA
wA_rahA_WA,m,s,m	rahA_WA
wA_rahA_WA,m,s,u	rahA_WA

wA_rahawA_hE,f,p,a	rahawIM_hEM
wA_rahawA_hE,f,p,m	rahawIM_ho
wA_rahawA_hE,f,p,u	rahawIM_hEM
wA_rahawA_hE,f,s,a	rahawI_hE
wA_rahawA_hE,f,s,m	rahawI_hE
wA_rahawA_hE,f,s,u	rahawI_hUz
wA_rahawA_hE,m,p,a	rahawe_hEM
wA_rahawA_hE,m,p,m	rahawe_ho
wA_rahawA_hE,m,p,u	rahawe_hEM
wA_rahawA_hE,m,s,a	rahawA_hE
wA_rahawA_hE,m,s,m	rahawA_hE
wA_rahawA_hE,m,s,u	rahawA_hUz

wA_rahanA_cAhiye_WA,f,p,a	wA_rahanA_cAhiye_WA
wA_rahanA_cAhiye_WA,f,p,m	wA_rahanA_cAhiye_WA
wA_rahanA_cAhiye_WA,f,p,u	wA_rahanA_cAhiye_WA
wA_rahanA_cAhiye_WA,f,s,a	wA_rahanA_cAhiye_WA
wA_rahanA_cAhiye_WA,f,s,m	wA_rahanA_cAhiye_WA
wA_rahanA_cAhiye_WA,f,s,u	wA_rahanA_cAhiye_WA
wA_rahanA_cAhiye_WA,m,p,a	wA_rahanA_cAhiye_WA
wA_rahanA_cAhiye_WA,m,p,m	wA_rahanA_cAhiye_WA
wA_rahanA_cAhiye_WA,m,p,u	wA_rahanA_cAhiye_WA
wA_rahanA_cAhiye_WA,m,s,a	wA_rahanA_cAhiye_WA
wA_rahanA_cAhiye_WA,m,s,m	wA_rahanA_cAhiye_WA
wA_rahanA_cAhiye_WA,m,s,u	wA_rahanA_cAhiye_WA

we_rahanA_hE,f,p,a	rahanA_hE
we_rahanA_hE,f,p,m	rahanA_hE
we_rahanA_hE,f,p,u	rahanA_hE
we_rahanA_hE,f,s,a	rahanA_hE
we_rahanA_hE,f,s,m	rahanA_hE
we_rahanA_hE,f,s,u	rahanA_hE
we_rahanA_hE,m,p,a	rahanA_hE
we_rahanA_hE,m,p,m	rahanA_hE
we_rahanA_hE,m,p,u	rahanA_hE
we_rahanA_hE,m,s,a	rahanA_hE
we_rahanA_hE,m,s,m	rahanA_hE
we_rahanA_hE,m,s,u	rahanA_hE

we_samaya,f,p,a	we_samaya
we_samaya,f,p,m	we_samaya
we_samaya,f,p,u	we_samaya
we_samaya,f,s,a	we_samaya
we_samaya,f,s,m	we_samaya
we_samaya,f,s,u	we_samaya
we_samaya,m,p,a	we_samaya
we_samaya,m,p,m	we_samaya
we_samaya,m,p,u	we_samaya
we_samaya,m,s,a	we_samaya
we_samaya,m,s,m	we_samaya
we_samaya,m,s,u	we_samaya

WI,f,p,a	WI
WI,f,p,m	WI
WI,f,p,u	WI
WI,f,s,a	WI
WI,f,s,m	WI
WI,f,s,u	WI
WI,m,p,a	WI
WI,m,p,m	WI
WI,m,p,u	WI
WI,m,s,a	WI
WI,m,s,m	WI
WI,m,s,u	WI

yA,f,p,a	KAIM
yA,f,p,m	KAIM
yA,f,p,u	KAIM
yA,f,s,a	KAI
yA,f,s,m	KAI
yA,f,s,u	KAI
yA,m,p,a	KAye
yA,m,p,m	KAye
yA,m,p,u	KAye
yA,m,s,a	KAyA
yA,m,s,m	KAyA
yA,m,s,u	KAyA

yA_hE,f,p,a	hEM
yA_hE,f,p,m	ho
yA_hE,f,p,u	hEM
yA_hE,f,s,a	hE
yA_hE,f,s,m	hE
yA_hE,f,s,u	hUz
yA_hE,m,p,a	hEM
yA_hE,m,p,m	ho
yA_hE,m,p,u	hEM
yA_hE,m,s,a	hE
yA_hE,m,s,m	hE
yA_hE,m,s,u	hUz

yA_ho,f,p,a	ho
yA_ho,f,p,m	ho
yA_ho,f,p,u	ho
yA_ho,f,s,a	ho
yA_ho,f,s,m	ho
yA_ho,f,s,u	ho
yA_ho,m,p,a	ho
yA_ho,m,p,m	ho
yA_ho,m,p,u	ho
yA_ho,m,s,a	ho
yA_ho,m,s,m	ho
yA_ho,m,s,u	ho

yA_WA,f,p,a	WIM
yA_WA,f,p,m	WIM
yA_WA,f,p,u	WIM
yA_WA,f,s,a	WI
yA_WA,f,s,m	WI
yA_WA,f,s,u	WI
yA_WA,m,p,a	We
yA_WA,m,p,m	We
yA_WA,m,p,u	We
yA_WA,m,s,a	WA
yA_WA,m,s,m	WA
yA_WA,m,s,u	WA

yA_gayA,f,p,a	gayIM
yA_gayA,f,p,m	gayIM
yA_gayA,f,p,u	gayIM
yA_gayA,f,s,a	gayI
yA_gayA,f,s,m	gayI
yA_gayA,f,s,u	gayI
yA_gayA,m,p,a	gaye
yA_gayA,m,p,m	gaye
yA_gayA,m,p,u	gaye
yA_gayA,m,s,a	gayA
yA_gayA,m,s,m	gayA
yA_gayA,m,s,u	gayA

yA_gayA_WA,f,p,a	gayIM_WIM
yA_gayA_WA,f,p,m	gayIM_WIM
yA_gayA_WA,f,p,u	gayIM_WIM
yA_gayA_WA,f,s,a	gayI_WI
yA_gayA_WA,f,s,m	gayI_WI
yA_gayA_WA,f,s,u	gayI_WI
yA_gayA_WA,m,p,a	gaye_We
yA_gayA_WA,m,p,m	gaye_We
yA_gayA_WA,m,p,u	gaye_We
yA_gayA_WA,m,s,a	gayA_WA
yA_gayA_WA,m,s,m	gayA_WA
yA_gayA_WA,m,s,u	gayA_WA

yA_gayA_hE,f,p,a	gayIM_hEM
yA_gayA_hE,f,p,m	gayIM_hEM
yA_gayA_hE,f,p,u	gayIM_hEM
yA_gayA_hE,f,s,a	gayI_hE
yA_gayA_hE,f,s,m	gayI_hE
yA_gayA_hE,f,s,u	gayI_hE
yA_gayA_hE,m,p,a	gaye_hEM
yA_gayA_hE,m,p,m	gaye_hEM
yA_gayA_hE,m,p,u	gaye_hEM
yA_gayA_hE,m,s,a	gayA_hE
yA_gayA_hE,m,s,m	gayA_hE
yA_gayA_hE,m,s,u	gayA_hUz

yA_gayA_hogA,f,p,a	gayIM_hoUzgA
yA_gayA_hogA,f,p,m	gayIM_hoUzgA
yA_gayA_hogA,f,p,u	gayIM_hoUzgA
yA_gayA_hogA,f,s,a	gayI_hoUzgA
yA_gayA_hogA,f,s,m	gayI_hoUzgA
yA_gayA_hogA,f,s,u	gayI_hoUzgA
yA_gayA_hogA,m,p,a	gaye_hoUzgA
yA_gayA_hogA,m,p,m	gaye_hoUzgA
yA_gayA_hogA,m,p,u	gaye_hoUzgA
yA_gayA_hogA,m,s,a	gayA_hoUzgA
yA_gayA_hogA,m,s,m	gayA_hoUzgA
yA_gayA_hogA,m,s,u	gayA_hoUzgA

yA_howA,f,p,a	howIM
yA_howA,f,p,m	howIM
yA_howA,f,p,u	howIM
yA_howA,f,s,a	howI
yA_howA,f,s,m	howI
yA_howA,f,s,u	howI
yA_howA,m,p,a	howe
yA_howA,m,p,m	howe
yA_howA,m,p,u	howe
yA_howA,m,s,a	howA
yA_howA,m,s,m	howA
yA_howA,m,s,u	howA

yA_hogA,f,p,a	hoMgI
yA_hogA,f,p,m	hoogI
yA_hogA,f,p,u	hoMgI
yA_hogA,f,s,a	hogI
yA_hogA,f,s,m	hogI
yA_hogA,f,s,u	hoUzgI
yA_hogA,m,p,a	hoMge
yA_hogA,m,p,m	hoge
yA_hogA,m,p,u	hoMge
yA_hogA,m,s,a	hogA
yA_hogA,m,s,m	hogA
yA_hogA,m,s,u	hoUzgA

yA_jAyegA,f,p,a	jAezgI
yA_jAyegA,f,p,m	jAogI
yA_jAyegA,f,p,u	jAezgI
yA_jAyegA,f,s,a	jAegI
yA_jAyegA,f,s,m	jAegI
yA_jAyegA,f,s,u	jAUzgI
yA_jAyegA,m,p,a	jAezge
yA_jAyegA,m,p,m	jAoge
yA_jAyegA,m,p,u	jAezge
yA_jAyegA,m,s,a	jAegA
yA_jAyegA,m,s,m	jAegA
yA_jAyegA,m,s,u	jAUzgA

yA_huA,f,p,a	huIM
yA_huA,f,p,m	huIM
yA_huA,f,p,u	huIM
yA_huA,f,s,a	huI
yA_huA,f,s,m	huI
yA_huA,f,s,u	huI
yA_huA,m,p,a	hue
yA_huA,m,p,m	hue
yA_huA,m,p,u	hue
yA_huA,m,s,a	huA
yA_huA,m,s,m	huA
yA_huA,m,s,u	huA

yA_huA_hE,f,p,a	huI_hEM
yA_huA_hE,f,p,m	huI_ho
yA_huA_hE,f,p,u	huI_hEM
yA_huA_hE,f,s,a	huI_hE
yA_huA_hE,f,s,m	huI_hE
yA_huA_hE,f,s,u	huI_hUz
yA_huA_hE,m,p,a	hue_hEM
yA_huA_hE,m,p,m	hue_ho
yA_huA_hE,m,p,u	hue_hEM
yA_huA_hE,m,s,a	huA_hE
yA_huA_hE,m,s,m	huA_ho
yA_huA_hE,m,s,u	huA_hUz

yA_huA_WA,f,p,a	huI_WIM
yA_huA_WA,f,p,m	hue_We
yA_huA_WA,f,p,u	huI_WIM
yA_huA_WA,f,s,a	huI_WI
yA_huA_WA,f,s,m	huI_WI
yA_huA_WA,f,s,u	huI_hUz
yA_huA_WA,m,p,a	hue_We
yA_huA_WA,m,p,m	hue_We
yA_huA_WA,m,p,u	hue_We
yA_huA_WA,m,s,a	huA_WA
yA_huA_WA,m,s,m	huA_WA
yA_huA_WA,m,s,u	huA_WA

yA_huA_hogA,f,p,a	yA_huA_hogA
yA_huA_hogA,f,p,m	yA_huA_hogA
yA_huA_hogA,f,p,u	yA_huA_hogA
yA_huA_hogA,f,s,a	yA_huA_hogA
yA_huA_hogA,f,s,m	yA_huA_hogA
yA_huA_hogA,f,s,u	yA_huA_hogA
yA_huA_hogA,m,p,a	yA_huA_hogA
yA_huA_hogA,m,p,m	yA_huA_hogA
yA_huA_hogA,m,p,u	yA_huA_hogA
yA_huA_hogA,m,s,a	yA_huA_hogA
yA_huA_hogA,m,s,m	yA_huA_hogA
yA_huA_hogA,m,s,u	yA_huA_hogA

yA_huA_nahIM_hogA,f,p,a	yA_huA_nahIM_hogA
yA_huA_nahIM_hogA,f,p,m	yA_huA_nahIM_hogA
yA_huA_nahIM_hogA,f,p,u	yA_huA_nahIM_hogA
yA_huA_nahIM_hogA,f,s,a	yA_huA_nahIM_hogA
yA_huA_nahIM_hogA,f,s,m	yA_huA_nahIM_hogA
yA_huA_nahIM_hogA,f,s,u	yA_huA_nahIM_hogA
yA_huA_nahIM_hogA,m,p,a	yA_huA_nahIM_hogA
yA_huA_nahIM_hogA,m,p,m	yA_huA_nahIM_hogA
yA_huA_nahIM_hogA,m,p,u	yA_huA_nahIM_hogA
yA_huA_nahIM_hogA,m,s,a	yA_huA_nahIM_hogA
yA_huA_nahIM_hogA,m,s,m	yA_huA_nahIM_hogA
yA_huA_nahIM_hogA,m,s,u	yA_huA_nahIM_hogA

yA_huA_honA,f,p,a	huIM_honA
yA_huA_honA,f,p,m	huIM_honA
yA_huA_honA,f,p,u	huIM_honA
yA_huA_honA,f,s,a	huI_honA
yA_huA_honA,f,s,m	huI_honA
yA_huA_honA,f,s,u	huI_honA
yA_huA_honA,m,p,a	hue_honA
yA_huA_honA,m,p,m	hue_honA
yA_huA_honA,m,p,u	hue_honA
yA_huA_honA,m,s,a	huA_honA
yA_huA_honA,m,s,m	huA_honA
yA_huA_honA,m,s,u	huA_honA

yA_huA_ho_sakawA_hE,f,p,a	huI_ho_sakawI_hEM
yA_huA_ho_sakawA_hE,f,p,m	huI_ho_sakawI_ho
yA_huA_ho_sakawA_hE,f,p,u	huI_ho_sakawI_hEM
yA_huA_ho_sakawA_hE,f,s,a	huI_ho_sakawI_hE
yA_huA_ho_sakawA_hE,f,s,m	huI_ho_sakawI_hE
yA_huA_ho_sakawA_hE,f,s,u	huI_ho_sakawI_hUM
yA_huA_ho_sakawA_hE,m,p,a	hue_ho_sakawe_hEM
yA_huA_ho_sakawA_hE,m,p,m	hue_ho_sakawe_ho
yA_huA_ho_sakawA_hE,m,p,u	hue_ho_sakawe_hEM
yA_huA_ho_sakawA_hE,m,s,a	huA_ho_sakawA_hE
yA_huA_ho_sakawA_hE,m,s,m	huA_ho_sakawA_hE
yA_huA_ho_sakawA_hE,m,s,u	huA_ho_sakawA_hUM

yA_jAwA_hE,f,p,a	jAwIM_hEM
yA_jAwA_hE,f,p,m	jAwIM_hEM
yA_jAwA_hE,f,p,u	jAwIM_hEM
yA_jAwA_hE,f,s,a	jAwI_hE
yA_jAwA_hE,f,s,m	jAwI_hE
yA_jAwA_hE,f,s,u	jAwI_hE
yA_jAwA_hE,m,p,a	jAwe_hEM
yA_jAwA_hE,m,p,m	jAwe_hEM
yA_jAwA_hE,m,p,u	jAwe_hEM
yA_jAwA_hE,m,s,a	jAwA_hE
yA_jAwA_hE,m,s,m	jAwA_hE
yA_jAwA_hE,m,s,u	jAwA_hUM

yA_jAwA_WA,f,p,a	jAwIM_WIM
yA_jAwA_WA,f,p,m	jAwIM_WIM
yA_jAwA_WA,f,p,u	jAwIM_WIM
yA_jAwA_WA,f,s,a	jAwI_WI
yA_jAwA_WA,f,s,m	jAwI_WI
yA_jAwA_WA,f,s,u	jAwI_WI
yA_jAwA_WA,m,p,a	jAwe_We
yA_jAwA_WA,m,p,m	jAwe_We
yA_jAwA_WA,m,p,u	jAwe_We
yA_jAwA_WA,m,s,a	jAwA_WA
yA_jAwA_WA,m,s,m	jAwA_WA
yA_jAwA_WA,m,s,u	jAwA_WA

yA_jAnA,f,p,a	jAnIM
yA_jAnA,f,p,m	jAneM
yA_jAnA,f,p,u	jAnIM
yA_jAnA,f,s,a	jAnI
yA_jAnA,f,s,m	jAnI
yA_jAnA,f,s,u	jAnI
yA_jAnA,m,p,a	jAne
yA_jAnA,m,p,m	jAne
yA_jAnA,m,p,u	jAne
yA_jAnA,m,s,a	jAnA
yA_jAnA,m,s,m	jAnA
yA_jAnA,m,s,u	jAnA

yA_jAnA_WA,f,p,a	jAnIM_WIM
yA_jAnA_WA,f,p,m	jAnIM_WIM
yA_jAnA_WA,f,p,u	jAnIM_WIM
yA_jAnA_WA,f,s,a	jAnI_WI
yA_jAnA_WA,f,s,m	jAnI_WI
yA_jAnA_WA,f,s,u	jAnI_WI
yA_jAnA_WA,m,p,a	jAne_We
yA_jAnA_WA,m,p,m	jAne_We
yA_jAnA_WA,m,p,u	jAne_We
yA_jAnA_WA,m,s,a	jAnA_WA
yA_jAnA_WA,m,s,m	jAnA_WA
yA_jAnA_WA,m,s,u	jAnA_WA

yA_jAnA_hE,m,s,a	jAnA_hE
yA_jAnA_hE,f,s,a	jAnI_hE
yA_jAnA_hE,m,p,a	jAne_hEM
yA_jAnA_hE,f,p,a	jAnI_hEM
yA_jAnA_hE,m,s,u	jAnA_hUz
yA_jAnA_hE,f,s,u	jAnI_hUz
yA_jAnA_hE,m,p,u	jAne_hEM
yA_jAnA_hE,f,p,u	jAne_hEM
yA_jAnA_hE,m,s,m	jAne_ho
yA_jAnA_hE,m,p,m	jAne_ho
yA_jAnA_hE,f,s,m	jAne_ho
yA_jAnA_hE,f,p,m	jAne_ho

yA_jAnA_cAhiye,f,p,a	jAnIM_cAhiye
yA_jAnA_cAhiye,f,p,m	jAnIM_cAhiye
yA_jAnA_cAhiye,f,p,u	jAnIM_cAhiye
yA_jAnA_cAhiye,f,s,a	jAnI_cAhiye
yA_jAnA_cAhiye,f,s,m	jAnI_cAhiye
yA_jAnA_cAhiye,f,s,u	jAnI_cAhiye
yA_jAnA_cAhiye,m,p,a	jAne_cAhiye
yA_jAnA_cAhiye,m,p,m	jAne_cAhiye
yA_jAnA_cAhiye,m,p,u	jAne_cAhiye
yA_jAnA_cAhiye,m,s,a	jAnA_cAhiye
yA_jAnA_cAhiye,m,s,m	jAnA_cAhiye
yA_jAnA_cAhiye,m,s,u	jAnA_cAhiye

yA_cAhiye_WA,f,p,a	yA_cAhiye_WA
yA_cAhiye_WA,f,p,m	yA_cAhiye_WA
yA_cAhiye_WA,f,p,u	yA_cAhiye_WA
yA_cAhiye_WA,f,s,a	yA_cAhiye_WA
yA_cAhiye_WA,f,s,m	yA_cAhiye_WA
yA_cAhiye_WA,f,s,u	yA_cAhiye_WA
yA_cAhiye_WA,m,p,a	yA_cAhiye_WA
yA_cAhiye_WA,m,p,m	yA_cAhiye_WA
yA_cAhiye_WA,m,p,u	yA_cAhiye_WA
yA_cAhiye_WA,m,s,a	yA_cAhiye_WA
yA_cAhiye_WA,m,s,m	yA_cAhiye_WA
yA_cAhiye_WA,m,s,u	yA_cAhiye_WA

yA_hI_WA,f,p,a	yA_hI_WA
yA_hI_WA,f,p,m	yA_hI_WA
yA_hI_WA,f,p,u	yA_hI_WA
yA_hI_WA,f,s,a	yA_hI_WA
yA_hI_WA,f,s,m	yA_hI_WA
yA_hI_WA,f,s,u	yA_hI_WA
yA_hI_WA,m,p,a	yA_hI_WA
yA_hI_WA,m,p,m	yA_hI_WA
yA_hI_WA,m,p,u	yA_hI_WA
yA_hI_WA,m,s,a	yA_hI_WA
yA_hI_WA,m,s,m	yA_hI_WA
yA_hI_WA,m,s,u	yA_hI_WA

yA_hI_jAnA_hE,f,p,a	yA_hI_jAnA_hE
yA_hI_jAnA_hE,f,p,m	yA_hI_jAnA_hE
yA_hI_jAnA_hE,f,p,u	yA_hI_jAnA_hE
yA_hI_jAnA_hE,f,s,a	yA_hI_jAnA_hE
yA_hI_jAnA_hE,f,s,m	yA_hI_jAnA_hE
yA_hI_jAnA_hE,f,s,u	yA_hI_jAnA_hE
yA_hI_jAnA_hE,m,p,a	yA_hI_jAnA_hE
yA_hI_jAnA_hE,m,p,m	yA_hI_jAnA_hE
yA_hI_jAnA_hE,m,p,u	yA_hI_jAnA_hE
yA_hI_jAnA_hE,m,s,a	yA_hI_jAnA_hE
yA_hI_jAnA_hE,m,s,m	yA_hI_jAnA_hE
yA_hI_jAnA_hE,m,s,u	yA_hI_jAnA_hE

yA_jA_sakA,f,p,a	jA_sakIM
yA_jA_sakA,f,p,m	jA_sakIM
yA_jA_sakA,f,p,u	jA_sakIM
yA_jA_sakA,f,s,a	jA_sakI
yA_jA_sakA,f,s,m	jA_sakI
yA_jA_sakA,f,s,u	jA_sakI
yA_jA_sakA,m,p,a	jA_sake
yA_jA_sakA,m,p,m	jA_sake
yA_jA_sakA,m,p,u	jA_sake
yA_jA_sakA,m,s,a	jA_sakA
yA_jA_sakA,m,s,m	jA_sakA
yA_jA_sakA,m,s,u	jA_sakA

yA_jA_sake,f,p,a	yA_jA_sake
yA_jA_sake,f,p,m	yA_jA_sake
yA_jA_sake,f,p,u	yA_jA_sake
yA_jA_sake,f,s,a	yA_jA_sake
yA_jA_sake,f,s,m	yA_jA_sake
yA_jA_sake,f,s,u	yA_jA_sake
yA_jA_sake,m,p,a	yA_jA_sake
yA_jA_sake,m,p,m	yA_jA_sake
yA_jA_sake,m,p,u	yA_jA_sake
yA_jA_sake,m,s,a	yA_jA_sake
yA_jA_sake,m,s,m	yA_jA_sake
yA_jA_sake,m,s,u	yA_jA_sake

yA_jA_sakawA_hE,f,p,a	jA_sakawIM_hEM
yA_jA_sakawA_hE,f,p,m	jA_sakawIM_hEM
yA_jA_sakawA_hE,f,p,u	jA_sakawIM_hEM
yA_jA_sakawA_hE,f,s,a	jA_sakawI_hE
yA_jA_sakawA_hE,f,s,m	jA_sakawI_hE
yA_jA_sakawA_hE,f,s,u	jA_sakawI_hE
yA_jA_sakawA_hE,m,p,a	jA_sakawe_hEM
yA_jA_sakawA_hE,m,p,m	jA_sakawe_hEM
yA_jA_sakawA_hE,m,p,u	jA_sakawe_hEM
yA_jA_sakawA_hE,m,s,a	jA_sakawA_hE
yA_jA_sakawA_hE,m,s,m	jA_sakawA_hE
yA_jA_sakawA_hE,m,s,u	jA_sakawA_hE

yA_jA_sakawA_WA,f,p,a	jA_sakawIM_WIM
yA_jA_sakawA_WA,f,p,m	jA_sakawIM_WIM
yA_jA_sakawA_WA,f,p,u	jA_sakawIM_WIM
yA_jA_sakawA_WA,f,s,a	jA_sakawI_WI
yA_jA_sakawA_WA,f,s,m	jA_sakawI_WI
yA_jA_sakawA_WA,f,s,u	jA_sakawI_WI
yA_jA_sakawA_WA,m,p,a	jA_sakawe_We
yA_jA_sakawA_WA,m,p,m	jA_sakawe_We
yA_jA_sakawA_WA,m,p,u	jA_sakawe_We
yA_jA_sakawA_WA,m,s,a	jA_sakawA_WA
yA_jA_sakawA_WA,m,s,m	jA_sakawA_WA
yA_jA_sakawA_WA,m,s,u	jA_sakawA_WA

yA_jA_rahA,f,p,a	yA_jA_rahA
yA_jA_rahA,f,p,m	yA_jA_rahA
yA_jA_rahA,f,p,u	yA_jA_rahA
yA_jA_rahA,f,s,a	yA_jA_rahA
yA_jA_rahA,f,s,m	yA_jA_rahA
yA_jA_rahA,f,s,u	yA_jA_rahA
yA_jA_rahA,m,p,a	yA_jA_rahA
yA_jA_rahA,m,p,m	yA_jA_rahA
yA_jA_rahA,m,p,u	yA_jA_rahA
yA_jA_rahA,m,s,a	yA_jA_rahA
yA_jA_rahA,m,s,m	yA_jA_rahA
yA_jA_rahA,m,s,u	yA_jA_rahA

yA_jA_rahA_WA,f,p,a	jA_rahIM_WIM
yA_jA_rahA_WA,f,p,m	jA_rahIM_WIM
yA_jA_rahA_WA,f,p,u	jA_rahIM_WIM
yA_jA_rahA_WA,f,s,a	jA_rahI_WI
yA_jA_rahA_WA,f,s,m	jA_rahI_WI
yA_jA_rahA_WA,f,s,u	jA_rahI_WI
yA_jA_rahA_WA,m,p,a	jA_rahe_We
yA_jA_rahA_WA,m,p,m	jA_rahe_We
yA_jA_rahA_WA,m,p,u	jA_rahe_We
yA_jA_rahA_WA,m,s,a	jA_rahA_WA
yA_jA_rahA_WA,m,s,m	jA_rahA_WA
yA_jA_rahA_WA,m,s,u	jA_rahA_WA

yA_jA_rahA_hE,f,p,a	jA_rahIM_hEM
yA_jA_rahA_hE,f,p,m	jA_rahIM_hEM
yA_jA_rahA_hE,f,p,u	jA_rahIM_hEM
yA_jA_rahA_hE,f,s,a	jA_rahI_hE
yA_jA_rahA_hE,f,s,m	jA_rahI_hE
yA_jA_rahA_hE,f,s,u	jA_rahI_hE
yA_jA_rahA_hE,m,p,a	jA_rahe_hEM
yA_jA_rahA_hE,m,p,m	jA_rahe_hEM
yA_jA_rahA_hE,m,p,u	jA_rahe_hEM
yA_jA_rahA_hE,m,s,a	jA_rahA_hE
yA_jA_rahA_hE,m,s,m	jA_rahA_hE
yA_jA_rahA_hE,m,s,u	jA_rahA_hE

yA_jA_rahA_hogA,f,p,a	yA_jA_rahA_hogA
yA_jA_rahA_hogA,f,p,m	yA_jA_rahA_hogA
yA_jA_rahA_hogA,f,p,u	yA_jA_rahA_hogA
yA_jA_rahA_hogA,f,s,a	yA_jA_rahA_hogA
yA_jA_rahA_hogA,f,s,m	yA_jA_rahA_hogA
yA_jA_rahA_hogA,f,s,u	yA_jA_rahA_hogA
yA_jA_rahA_hogA,m,p,a	yA_jA_rahA_hogA
yA_jA_rahA_hogA,m,p,m	yA_jA_rahA_hogA
yA_jA_rahA_hogA,m,p,u	yA_jA_rahA_hogA
yA_jA_rahA_hogA,m,s,a	yA_jA_rahA_hogA
yA_jA_rahA_hogA,m,s,m	yA_jA_rahA_hogA
yA_jA_rahA_hogA,m,s,u	yA_jA_rahA_hogA

yA_karawA_WA,f,p,a	karawIM_WIM
yA_karawA_WA,f,p,m	karawIM_WIM
yA_karawA_WA,f,p,u	karawIM_WIM
yA_karawA_WA,f,s,a	karawI_WI
yA_karawA_WA,f,s,m	karawI_WI
yA_karawA_WA,f,s,u	karawI_WI
yA_karawA_WA,m,p,a	karawe_We
yA_karawA_WA,m,p,m	karawe_We
yA_karawA_WA,m,p,u	karawe_We
yA_karawA_WA,m,s,a	karawA_WA
yA_karawA_WA,m,s,m	karawA_WA
yA_karawA_WA,m,s,u	karawA_WA

ye_binA,f,p,a	ye_binA
ye_binA,f,p,m	ye_binA
ye_binA,f,p,u	ye_binA
ye_binA,f,s,a	ye_binA
ye_binA,f,s,m	ye_binA
ye_binA,f,s,u	ye_binA
ye_binA,m,p,a	ye_binA
ye_binA,m,p,m	ye_binA
ye_binA,m,p,u	ye_binA
ye_binA,m,s,a	ye_binA
ye_binA,m,s,m	ye_binA
ye_binA,m,s,u	ye_binA
